name,inventory,min_price,max_price,current_price,rating,strategy,slug,product(fk),discount
"Samsung 55"" 4K Smart TV",718,36800,62400,45504,1,1,samsung_55_4k_smart_tv-0,3,16896
"Samsung 55"" 4K Smart TV",499,35600,62400,47928,2,2,samsung_55_4k_smart_tv-1,4,14472
"Samsung 55"" 4K Smart TV",517,36800,67800,56175,4,5,samsung_55_4k_smart_tv-2,5,11625
"Samsung 55"" 4K Smart TV",292,39600,60600,53250,5,4,samsung_55_4k_smart_tv-3,6,7350
"Samsung 55"" 4K Smart TV",431,37200,60600,51591,3,1,samsung_55_4k_smart_tv-4,7,9009
"Samsung 55"" 4K Smart TV",89,34000,68400,43632,1,2,samsung_55_4k_smart_tv-5,8,24768
"Samsung 55"" 4K Smart TV",427,39200,64200,57325,5,1,samsung_55_4k_smart_tv-6,9,6875
"Samsung 55"" 4K Smart TV",685,37600,64800,55280,5,4,samsung_55_4k_smart_tv-7,10,9520
"Samsung 55"" 4K Smart TV",479,38400,66000,51510,3,5,samsung_55_4k_smart_tv-8,11,14490
"Samsung 55"" 4K Smart TV",568,34800,69000,55833,3,1,samsung_55_4k_smart_tv-9,12,13167
"Samsung 55"" 4K Smart TV",613,36400,64800,56990,4,1,samsung_55_4k_smart_tv-10,13,7810
"Samsung 55"" 4K Smart TV",176,36400,62400,39000,1,5,samsung_55_4k_smart_tv-11,14,23400
"Samsung 55"" 4K Smart TV",422,34400,67200,45552,1,1,samsung_55_4k_smart_tv-12,15,21648
"Samsung 55"" 4K Smart TV",58,38800,64200,55310,5,4,samsung_55_4k_smart_tv-13,16,8890
"Samsung 55"" 4K Smart TV",725,38400,69000,56148,3,2,samsung_55_4k_smart_tv-14,17,12852
"Samsung 55"" 4K Smart TV",868,34400,64200,53770,4,4,samsung_55_4k_smart_tv-15,18,10430
"Samsung 55"" 4K Smart TV",488,36000,66600,42732,1,3,samsung_55_4k_smart_tv-16,19,23868
"Samsung 55"" 4K Smart TV",714,37600,69000,52515,3,5,samsung_55_4k_smart_tv-17,20,16485
"Samsung 55"" 4K Smart TV",319,39600,61800,45816,1,2,samsung_55_4k_smart_tv-18,21,15984
"Samsung 55"" 4K Smart TV",163,37200,62400,53580,4,4,samsung_55_4k_smart_tv-19,22,8820
"Samsung 55"" 4K Smart TV",615,39600,67200,56850,5,5,samsung_55_4k_smart_tv-20,23,10350
"Samsung 55"" 4K Smart TV",606,36400,65400,54525,4,5,samsung_55_4k_smart_tv-21,24,10875
"Samsung 55"" 4K Smart TV",772,36400,67200,55650,4,5,samsung_55_4k_smart_tv-22,25,11550
"Samsung 55"" 4K Smart TV",26,37200,68400,50148,2,3,samsung_55_4k_smart_tv-23,26,18252
"Samsung 55"" 4K Smart TV",500,37600,65400,54697,3,1,samsung_55_4k_smart_tv-24,27,10703
"Samsung 55"" 4K Smart TV",718,34400,60600,37020,1,5,samsung_55_4k_smart_tv-25,28,23580
"Samsung 55"" 4K Smart TV",257,39200,61200,52950,4,5,samsung_55_4k_smart_tv-26,29,8250
"LG 65"" OLED 4K Ultra HD TV",574,58200,101700,87563,5,3,lg_65_oled_4k_ultra_hd_tv-0,30,14137
"LG 65"" OLED 4K Ultra HD TV",171,59400,99000,70488,1,2,lg_65_oled_4k_ultra_hd_tv-1,31,28512
"LG 65"" OLED 4K Ultra HD TV",808,51600,97200,61632,1,3,lg_65_oled_4k_ultra_hd_tv-2,32,35568
"LG 65"" OLED 4K Ultra HD TV",121,58200,94500,81795,5,4,lg_65_oled_4k_ultra_hd_tv-3,33,12705
"LG 65"" OLED 4K Ultra HD TV",432,52200,95400,83520,4,1,lg_65_oled_4k_ultra_hd_tv-4,34,11880
"LG 65"" OLED 4K Ultra HD TV",164,51600,97200,80100,5,5,lg_65_oled_4k_ultra_hd_tv-5,35,17100
"LG 65"" OLED 4K Ultra HD TV",140,54000,97200,82080,4,4,lg_65_oled_4k_ultra_hd_tv-6,36,15120
"LG 65"" OLED 4K Ultra HD TV",833,57000,91800,60480,1,5,lg_65_oled_4k_ultra_hd_tv-7,37,31320
"LG 65"" OLED 4K Ultra HD TV",807,58200,91800,81720,4,2,lg_65_oled_4k_ultra_hd_tv-8,38,10080
"LG 65"" OLED 4K Ultra HD TV",518,57000,103500,89550,4,2,lg_65_oled_4k_ultra_hd_tv-9,39,13950
"LG 65"" OLED 4K Ultra HD TV",855,59400,99000,83754,3,1,lg_65_oled_4k_ultra_hd_tv-10,40,15246
"LG 65"" OLED 4K Ultra HD TV",109,55200,96300,84998,5,1,lg_65_oled_4k_ultra_hd_tv-11,41,11302
"LG 65"" OLED 4K Ultra HD TV",326,56400,102600,87585,4,3,lg_65_oled_4k_ultra_hd_tv-12,42,15015
"LG 65"" OLED 4K Ultra HD TV",33,57000,99900,81882,3,2,lg_65_oled_4k_ultra_hd_tv-13,43,18018
"LG 65"" OLED 4K Ultra HD TV",630,57000,103500,67230,1,3,lg_65_oled_4k_ultra_hd_tv-14,44,36270
"LG 65"" OLED 4K Ultra HD TV",353,57000,96300,65646,1,3,lg_65_oled_4k_ultra_hd_tv-15,45,30654
"LG 65"" OLED 4K Ultra HD TV",844,58200,99000,84720,5,4,lg_65_oled_4k_ultra_hd_tv-16,46,14280
"LG 65"" OLED 4K Ultra HD TV",959,54600,96300,71906,2,3,lg_65_oled_4k_ultra_hd_tv-17,47,24394
"LG 65"" OLED 4K Ultra HD TV",248,57000,99000,78210,2,1,lg_65_oled_4k_ultra_hd_tv-18,48,20790
"LG 65"" OLED 4K Ultra HD TV",901,52200,100800,76986,3,4,lg_65_oled_4k_ultra_hd_tv-19,49,23814
"Sony 50"" Full HD LED TV",500,26700,49050,37317,3,5,sony_50_full_hd_led_tv-0,50,11733
"Sony 50"" Full HD LED TV",160,28800,45900,37521,3,4,sony_50_full_hd_led_tv-1,51,8379
"Sony 50"" Full HD LED TV",436,26700,48600,42578,4,1,sony_50_full_hd_led_tv-2,52,6022
"Sony 50"" Full HD LED TV",440,27000,46350,39578,5,4,sony_50_full_hd_led_tv-3,53,6772
"Sony 50"" Full HD LED TV",632,28500,47250,40688,5,4,sony_50_full_hd_led_tv-4,54,6562
"Sony 50"" Full HD LED TV",928,26700,51300,38385,3,5,sony_50_full_hd_led_tv-5,55,12915
"Sony 50"" Full HD LED TV",282,26400,46800,40680,4,2,sony_50_full_hd_led_tv-6,56,6120
"Sony 50"" Full HD LED TV",462,29100,46350,39882,4,5,sony_50_full_hd_led_tv-7,57,6468
"Sony 50"" Full HD LED TV",159,28800,50850,43133,4,4,sony_50_full_hd_led_tv-8,58,7717
"Sony 50"" Full HD LED TV",183,29700,50850,44505,4,2,sony_50_full_hd_led_tv-9,59,6345
"Sony 50"" Full HD LED TV",909,26400,51300,42585,4,4,sony_50_full_hd_led_tv-10,60,8715
"Sony 50"" Full HD LED TV",323,28200,46350,38092,3,3,sony_50_full_hd_led_tv-11,61,8258
"Sony 50"" Full HD LED TV",832,28200,47250,32391,1,3,sony_50_full_hd_led_tv-12,62,14859
"Sony 50"" Full HD LED TV",704,28800,46800,35460,2,4,sony_50_full_hd_led_tv-13,63,11340
"Sony 50"" Full HD LED TV",64,27900,47700,40275,5,5,sony_50_full_hd_led_tv-14,64,7425
"Sony 50"" Full HD LED TV",336,26400,51300,39971,3,3,sony_50_full_hd_led_tv-15,65,11329
"Sony 50"" Full HD LED TV",825,26700,50850,44209,4,1,sony_50_full_hd_led_tv-16,66,6641
"Sony 50"" Full HD LED TV",245,25800,46800,38925,5,5,sony_50_full_hd_led_tv-17,67,7875
"Sony 50"" Full HD LED TV",452,28800,45450,32463,1,3,sony_50_full_hd_led_tv-18,68,12987
"Sony 50"" Full HD LED TV",669,28200,47250,30105,1,5,sony_50_full_hd_led_tv-19,69,17145
"Sony 50"" Full HD LED TV",48,27000,46350,28935,1,5,sony_50_full_hd_led_tv-20,70,17415
"TCL 43"" Roku Smart TV",772,22500,42000,32445,3,4,tcl_43_roku_smart_tv-0,71,9555
"TCL 43"" Roku Smart TV",401,21500,40500,33850,4,4,tcl_43_roku_smart_tv-1,72,6650
"TCL 43"" Roku Smart TV",841,22250,41250,34125,5,5,tcl_43_roku_smart_tv-2,73,7125
"TCL 43"" Roku Smart TV",291,24750,39375,34622,4,3,tcl_43_roku_smart_tv-3,74,4753
"TCL 43"" Roku Smart TV",728,24000,42000,30120,1,1,tcl_43_roku_smart_tv-4,75,11880
"TCL 43"" Roku Smart TV",246,22250,41625,28547,2,5,tcl_43_roku_smart_tv-5,76,13078
"TCL 43"" Roku Smart TV",254,24750,37875,31904,3,3,tcl_43_roku_smart_tv-6,77,5971
"TCL 43"" Roku Smart TV",976,24500,40875,29085,1,2,tcl_43_roku_smart_tv-7,78,11790
"TCL 43"" Roku Smart TV",937,23250,38625,31630,3,3,tcl_43_roku_smart_tv-8,79,6995
"TCL 43"" Roku Smart TV",595,22500,40125,32106,3,3,tcl_43_roku_smart_tv-9,80,8019
"TCL 43"" Roku Smart TV",458,23500,38625,31214,3,4,tcl_43_roku_smart_tv-10,81,7411
"TCL 43"" Roku Smart TV",511,23250,38250,27450,1,2,tcl_43_roku_smart_tv-11,82,10800
"TCL 43"" Roku Smart TV",274,22500,41250,35157,5,3,tcl_43_roku_smart_tv-12,83,6093
"TCL 43"" Roku Smart TV",822,23750,37875,26858,1,3,tcl_43_roku_smart_tv-13,84,11017
"TCL 43"" Roku Smart TV",172,22000,41625,30145,2,3,tcl_43_roku_smart_tv-14,85,11480
"TCL 43"" Roku Smart TV",408,22500,39000,33225,5,4,tcl_43_roku_smart_tv-15,86,5775
"TCL 43"" Roku Smart TV",611,21750,42375,33713,3,2,tcl_43_roku_smart_tv-16,87,8662
"TCL 43"" Roku Smart TV",975,24250,39375,28485,1,2,tcl_43_roku_smart_tv-17,88,10890
"TCL 43"" Roku Smart TV",396,23500,37875,30329,3,5,tcl_43_roku_smart_tv-18,89,7546
"TCL 43"" Roku Smart TV",129,22750,39750,29805,2,3,tcl_43_roku_smart_tv-19,90,9945
"TCL 43"" Roku Smart TV",815,24000,41250,36507,4,1,tcl_43_roku_smart_tv-20,91,4743
"TCL 43"" Roku Smart TV",375,24500,42750,37275,5,2,tcl_43_roku_smart_tv-21,92,5475
"TCL 43"" Roku Smart TV",843,23250,42000,36375,5,2,tcl_43_roku_smart_tv-22,93,5625
"TCL 43"" Roku Smart TV",992,23750,40500,29948,2,4,tcl_43_roku_smart_tv-23,94,10552
"TCL 43"" Roku Smart TV",547,22000,40500,34950,4,2,tcl_43_roku_smart_tv-24,95,5550
"TCL 43"" Roku Smart TV",326,24250,41625,36413,5,2,tcl_43_roku_smart_tv-25,96,5212
"TCL 43"" Roku Smart TV",508,24250,40125,34172,4,5,tcl_43_roku_smart_tv-26,97,5953
"TCL 43"" Roku Smart TV",753,21750,37875,28442,2,3,tcl_43_roku_smart_tv-27,98,9433
"TCL 43"" Roku Smart TV",213,22250,39375,32183,3,2,tcl_43_roku_smart_tv-28,99,7192
"Vizio 60"" 4K HDR Smart TV",449,40950,76950,63450,5,5,vizio_60_4k_hdr_smart_tv-0,100,13500
"Vizio 60"" 4K HDR Smart TV",579,43200,74250,63383,5,4,vizio_60_4k_hdr_smart_tv-1,101,10867
"Vizio 60"" 4K HDR Smart TV",760,38700,74250,53454,2,3,vizio_60_4k_hdr_smart_tv-2,102,20796
"Vizio 60"" 4K HDR Smart TV",122,44550,76275,64061,3,1,vizio_60_4k_hdr_smart_tv-3,103,12214
"Vizio 60"" 4K HDR Smart TV",438,38250,70200,48634,2,5,vizio_60_4k_hdr_smart_tv-4,104,21566
"Vizio 60"" 4K HDR Smart TV",834,44100,70200,48276,1,4,vizio_60_4k_hdr_smart_tv-5,105,21924
"Vizio 60"" 4K HDR Smart TV",664,43650,76275,67304,4,1,vizio_60_4k_hdr_smart_tv-6,106,8971
"Vizio 60"" 4K HDR Smart TV",979,44550,76275,47723,1,5,vizio_60_4k_hdr_smart_tv-7,107,28552
"Vizio 60"" 4K HDR Smart TV",256,42750,77625,60362,2,1,vizio_60_4k_hdr_smart_tv-8,108,17263
"Vizio 60"" 4K HDR Smart TV",226,44100,74925,52731,1,2,vizio_60_4k_hdr_smart_tv-9,109,22194
"Vizio 60"" 4K HDR Smart TV",399,38250,72900,59907,4,5,vizio_60_4k_hdr_smart_tv-10,110,12993
"Vizio 60"" 4K HDR Smart TV",143,44550,75600,59299,3,5,vizio_60_4k_hdr_smart_tv-11,111,16301
"Vizio 60"" 4K HDR Smart TV",329,41400,69525,55604,2,1,vizio_60_4k_hdr_smart_tv-12,112,13921
"Vizio 60"" 4K HDR Smart TV",910,42750,74250,64013,5,3,vizio_60_4k_hdr_smart_tv-13,113,10237
"Vizio 60"" 4K HDR Smart TV",463,38250,74925,64840,4,1,vizio_60_4k_hdr_smart_tv-14,114,10085
"Vizio 60"" 4K HDR Smart TV",109,42300,75600,65610,5,2,vizio_60_4k_hdr_smart_tv-15,115,9990
"Vizio 60"" 4K HDR Smart TV",356,38700,70875,58810,5,5,vizio_60_4k_hdr_smart_tv-16,116,12065
"Vizio 60"" 4K HDR Smart TV",665,43200,70875,63265,4,1,vizio_60_4k_hdr_smart_tv-17,117,7610
"Vizio 60"" 4K HDR Smart TV",92,42750,68175,61184,4,1,vizio_60_4k_hdr_smart_tv-18,118,6991
"Vizio 60"" 4K HDR Smart TV",950,40050,77625,67292,4,1,vizio_60_4k_hdr_smart_tv-19,119,10333
"Hisense 55"" 4K Android TV",286,37200,66600,40140,1,5,hisense_55_4k_android_tv-0,120,26460
"Hisense 55"" 4K Android TV",696,36800,60600,52865,5,3,hisense_55_4k_android_tv-1,121,7735
"Hisense 55"" 4K Android TV",893,36400,63600,50136,2,1,hisense_55_4k_android_tv-2,122,13464
"Hisense 55"" 4K Android TV",449,36800,63600,45510,2,5,hisense_55_4k_android_tv-3,123,18090
"Hisense 55"" 4K Android TV",890,34000,60600,47566,3,4,hisense_55_4k_android_tv-4,124,13034
"Hisense 55"" 4K Android TV",494,35600,61200,44304,1,1,hisense_55_4k_android_tv-5,125,16896
"Hisense 55"" 4K Android TV",618,39200,67800,55788,3,2,hisense_55_4k_android_tv-6,126,12012
"Hisense 55"" 4K Android TV",376,39600,66600,43920,1,4,hisense_55_4k_android_tv-7,127,22680
"Hisense 55"" 4K Android TV",424,38400,61200,48888,2,2,hisense_55_4k_android_tv-8,128,12312
"Hisense 55"" 4K Android TV",52,39600,67200,56850,4,5,hisense_55_4k_android_tv-9,129,10350
"Hisense 55"" 4K Android TV",341,35200,66000,57530,4,1,hisense_55_4k_android_tv-10,130,8470
"Hisense 55"" 4K Android TV",725,39600,67800,52995,3,5,hisense_55_4k_android_tv-11,131,14805
"Hisense 55"" 4K Android TV",702,34400,61200,51820,5,4,hisense_55_4k_android_tv-12,132,9380
"Hisense 55"" 4K Android TV",673,39200,68400,59640,4,2,hisense_55_4k_android_tv-13,133,8760
"Hisense 55"" 4K Android TV",685,35200,67800,54108,3,2,hisense_55_4k_android_tv-14,134,13692
"Hisense 55"" 4K Android TV",122,34800,66600,52131,3,3,hisense_55_4k_android_tv-15,135,14469
"Hisense 55"" 4K Android TV",611,35200,66600,42108,1,3,hisense_55_4k_android_tv-16,136,24492
"Hisense 55"" 4K Android TV",619,38800,65400,58085,4,1,hisense_55_4k_android_tv-17,137,7315
"Hisense 55"" 4K Android TV",492,36400,66000,56380,4,3,hisense_55_4k_android_tv-18,138,9620
"Hisense 55"" 4K Android TV",669,34000,60600,42645,2,5,hisense_55_4k_android_tv-19,139,17955
"Hisense 55"" 4K Android TV",498,36400,66600,50292,2,2,hisense_55_4k_android_tv-20,140,16308
"Hisense 55"" 4K Android TV",980,38800,69000,59940,4,2,hisense_55_4k_android_tv-21,141,9060
"Hisense 55"" 4K Android TV",129,34400,66600,57745,4,1,hisense_55_4k_android_tv-22,142,8855
"Philips 70"" 4K HDR TV",217,68600,111300,80556,1,2,philips_70_4k_hdr_tv-0,143,30744
"Philips 70"" 4K HDR TV",854,63000,119700,81428,2,5,philips_70_4k_hdr_tv-1,144,38272
"Philips 70"" 4K HDR TV",33,63700,113400,98490,5,2,philips_70_4k_hdr_tv-2,145,14910
"Philips 70"" 4K HDR TV",684,65100,113400,100118,5,1,philips_70_4k_hdr_tv-3,146,13282
"Philips 70"" 4K HDR TV",477,64400,119700,89838,2,2,philips_70_4k_hdr_tv-4,147,29862
"Philips 70"" 4K HDR TV",897,69300,111300,98700,5,2,philips_70_4k_hdr_tv-5,148,12600
"Philips 70"" 4K HDR TV",472,62300,111300,73080,1,3,philips_70_4k_hdr_tv-6,149,38220
"Philips 70"" 4K HDR TV",988,67900,108150,76755,1,3,philips_70_4k_hdr_tv-7,150,31395
"Philips 70"" 4K HDR TV",113,68600,114450,73185,1,5,philips_70_4k_hdr_tv-8,151,41265
"Philips 70"" 4K HDR TV",830,63000,110250,86862,2,1,philips_70_4k_hdr_tv-9,152,23388
"Philips 70"" 4K HDR TV",610,61600,109200,83496,2,2,philips_70_4k_hdr_tv-10,153,25704
"Philips 70"" 4K HDR TV",226,66500,118650,71715,1,5,philips_70_4k_hdr_tv-11,154,46935
"Philips 70"" 4K HDR TV",552,65100,114450,83360,2,4,philips_70_4k_hdr_tv-12,155,31090
"Philips 70"" 4K HDR TV",29,60200,117600,97510,5,4,philips_70_4k_hdr_tv-13,156,20090
"Philips 70"" 4K HDR TV",813,64400,112350,93890,3,1,philips_70_4k_hdr_tv-14,157,18460
"Philips 70"" 4K HDR TV",36,69300,115500,100485,4,3,philips_70_4k_hdr_tv-15,158,15015
"Philips 70"" 4K HDR TV",585,67900,111300,80052,1,2,philips_70_4k_hdr_tv-16,159,31248
"Philips 70"" 4K HDR TV",173,65100,108150,69405,1,5,philips_70_4k_hdr_tv-17,160,38745
"Philips 70"" 4K HDR TV",953,60900,109200,77322,1,1,philips_70_4k_hdr_tv-18,161,31878
"Philips 70"" 4K HDR TV",597,59500,114450,82305,2,3,philips_70_4k_hdr_tv-19,162,32145
"Philips 70"" 4K HDR TV",631,69300,116550,103557,4,1,philips_70_4k_hdr_tv-20,163,12993
"Philips 70"" 4K HDR TV",556,65100,110250,83838,2,3,philips_70_4k_hdr_tv-21,164,26412
"Panasonic 65"" 4K Ultra HD TV",821,59400,98100,70236,1,2,panasonic_65_4k_ultra_hd_tv-0,165,27864
"Panasonic 65"" 4K Ultra HD TV",755,54000,97200,82080,5,4,panasonic_65_4k_ultra_hd_tv-1,166,15120
"Panasonic 65"" 4K Ultra HD TV",563,51000,94500,79275,4,4,panasonic_65_4k_ultra_hd_tv-2,167,15225
"Panasonic 65"" 4K Ultra HD TV",922,52800,103500,83981,3,1,panasonic_65_4k_ultra_hd_tv-3,168,19519
"Panasonic 65"" 4K Ultra HD TV",802,52200,96300,72486,2,2,panasonic_65_4k_ultra_hd_tv-4,169,23814
"Panasonic 65"" 4K Ultra HD TV",488,57600,92700,83048,4,1,panasonic_65_4k_ultra_hd_tv-5,170,9652
"Panasonic 65"" 4K Ultra HD TV",870,57600,93600,82800,4,2,panasonic_65_4k_ultra_hd_tv-6,171,10800
"Panasonic 65"" 4K Ultra HD TV",735,55200,94500,67973,2,5,panasonic_65_4k_ultra_hd_tv-7,172,26527
"Panasonic 65"" 4K Ultra HD TV",786,53400,101700,87210,5,2,panasonic_65_4k_ultra_hd_tv-8,173,14490
"Panasonic 65"" 4K Ultra HD TV",988,57600,94500,69593,2,5,panasonic_65_4k_ultra_hd_tv-9,174,24907
"Panasonic 65"" 4K Ultra HD TV",93,51600,96300,79538,4,5,panasonic_65_4k_ultra_hd_tv-10,175,16762
"Panasonic 65"" 4K Ultra HD TV",786,57000,99000,86400,5,2,panasonic_65_4k_ultra_hd_tv-11,176,12600
"Panasonic 65"" 4K Ultra HD TV",120,52800,99000,60192,1,4,panasonic_65_4k_ultra_hd_tv-12,177,38808
"Panasonic 65"" 4K Ultra HD TV",106,55800,94500,71861,2,3,panasonic_65_4k_ultra_hd_tv-13,178,22639
"Panasonic 65"" 4K Ultra HD TV",166,51600,93600,65880,1,1,panasonic_65_4k_ultra_hd_tv-14,179,27720
"Panasonic 65"" 4K Ultra HD TV",745,55800,99900,83363,4,5,panasonic_65_4k_ultra_hd_tv-15,180,16537
"Panasonic 65"" 4K Ultra HD TV",612,56400,94500,75641,2,1,panasonic_65_4k_ultra_hd_tv-16,181,18859
"Panasonic 65"" 4K Ultra HD TV",527,58800,103500,86291,3,1,panasonic_65_4k_ultra_hd_tv-17,182,17209
"Panasonic 65"" 4K Ultra HD TV",702,53400,96300,62838,1,3,panasonic_65_4k_ultra_hd_tv-18,183,33462
"Panasonic 65"" 4K Ultra HD TV",126,54000,101700,78089,2,1,panasonic_65_4k_ultra_hd_tv-19,184,23611
"Panasonic 65"" 4K Ultra HD TV",675,52200,99000,59688,1,4,panasonic_65_4k_ultra_hd_tv-20,185,39312
"Panasonic 65"" 4K Ultra HD TV",685,57000,101700,69516,1,2,panasonic_65_4k_ultra_hd_tv-21,186,32184
"Panasonic 65"" 4K Ultra HD TV",619,58800,99000,75483,2,3,panasonic_65_4k_ultra_hd_tv-22,187,23517
"Panasonic 65"" 4K Ultra HD TV",874,51600,102600,59760,1,4,panasonic_65_4k_ultra_hd_tv-23,188,42840
"Panasonic 65"" 4K Ultra HD TV",891,56400,98100,85590,4,2,panasonic_65_4k_ultra_hd_tv-24,189,12510
"Panasonic 65"" 4K Ultra HD TV",568,59400,90900,62550,1,5,panasonic_65_4k_ultra_hd_tv-25,190,28350
"Panasonic 65"" 4K Ultra HD TV",881,57600,99000,61740,1,5,panasonic_65_4k_ultra_hd_tv-26,191,37260
"Panasonic 65"" 4K Ultra HD TV",920,57000,101700,81362,3,3,panasonic_65_4k_ultra_hd_tv-27,192,20338
"Sharp 50"" 4K Android TV",598,34300,59325,51818,5,2,sharp_50_4k_android_tv-0,193,7507
"Sharp 50"" 4K Android TV",69,32550,57750,48930,5,4,sharp_50_4k_android_tv-1,194,8820
"Sharp 50"" 4K Android TV",581,31500,58800,50610,4,2,sharp_50_4k_android_tv-2,195,8190
"Sharp 50"" 4K Android TV",850,33250,55650,47250,5,5,sharp_50_4k_android_tv-3,196,8400
"Sharp 50"" 4K Android TV",761,32900,59325,45452,3,5,sharp_50_4k_android_tv-4,197,13873
"Sharp 50"" 4K Android TV",935,33600,60375,45917,2,2,sharp_50_4k_android_tv-5,198,14458
"Sharp 50"" 4K Android TV",585,34650,54075,47277,4,4,sharp_50_4k_android_tv-6,199,6798
"Sharp 50"" 4K Android TV",553,33250,60375,40845,1,2,sharp_50_4k_android_tv-7,200,19530
"Sharp 50"" 4K Android TV",486,29750,54075,46778,5,2,sharp_50_4k_android_tv-8,201,7297
"Sharp 50"" 4K Android TV",589,34650,57750,42158,2,5,sharp_50_4k_android_tv-9,202,15592
"Sharp 50"" 4K Android TV",186,33600,53550,47067,5,3,sharp_50_4k_android_tv-10,203,6483
"Sharp 50"" 4K Android TV",515,30100,55650,48624,5,1,sharp_50_4k_android_tv-11,204,7026
"Sharp 50"" 4K Android TV",67,33950,60375,52448,5,2,sharp_50_4k_android_tv-12,205,7927
"Sharp 50"" 4K Android TV",821,30450,58275,39494,2,5,sharp_50_4k_android_tv-13,206,18781
"Sharp 50"" 4K Android TV",973,34650,57750,41118,1,2,sharp_50_4k_android_tv-14,207,16632
"Sharp 50"" 4K Android TV",50,33950,56175,49508,5,2,sharp_50_4k_android_tv-15,208,6667
"Sharp 50"" 4K Android TV",211,34300,57225,45190,3,5,sharp_50_4k_android_tv-16,209,12035
"Sharp 50"" 4K Android TV",470,31500,54075,47867,4,1,sharp_50_4k_android_tv-17,210,6208
"Sharp 50"" 4K Android TV",583,34650,60375,47770,3,4,sharp_50_4k_android_tv-18,211,12605
"Sharp 50"" 4K Android TV",883,33250,58800,49858,4,4,sharp_50_4k_android_tv-19,212,8942
"Sharp 50"" 4K Android TV",599,30100,59850,36645,1,3,sharp_50_4k_android_tv-20,213,23205
"Sharp 50"" 4K Android TV",973,33250,55650,38178,1,3,sharp_50_4k_android_tv-21,214,17472
"Sharp 50"" 4K Android TV",130,33600,57225,44822,3,5,sharp_50_4k_android_tv-22,215,12403
"Sharp 50"" 4K Android TV",520,31150,58800,49123,5,4,sharp_50_4k_android_tv-23,216,9677
"Toshiba 55"" Fire TV Edition",523,36400,66600,57540,4,2,toshiba_55_fire_tv_edition-0,217,9060
"Toshiba 55"" Fire TV Edition",318,36800,66600,56915,4,3,toshiba_55_fire_tv_edition-1,218,9685
"Toshiba 55"" Fire TV Edition",479,35200,65400,38220,1,5,toshiba_55_fire_tv_edition-2,219,27180
"Toshiba 55"" Fire TV Edition",360,36800,66600,56170,5,4,toshiba_55_fire_tv_edition-3,220,10430
"Toshiba 55"" Fire TV Edition",645,34000,66000,57200,5,1,toshiba_55_fire_tv_edition-4,221,8800
"Toshiba 55"" Fire TV Edition",708,38400,61800,48111,2,3,toshiba_55_fire_tv_edition-5,222,13689
"Toshiba 55"" Fire TV Edition",250,37600,63000,51443,3,3,toshiba_55_fire_tv_edition-6,223,11557
"Toshiba 55"" Fire TV Edition",246,34800,69000,50532,2,2,toshiba_55_fire_tv_edition-7,224,18468
"Toshiba 55"" Fire TV Edition",826,36000,64200,53625,4,5,toshiba_55_fire_tv_edition-8,225,10575
"Toshiba 55"" Fire TV Edition",525,35200,63600,51672,3,2,toshiba_55_fire_tv_edition-9,226,11928
"Toshiba 55"" Fire TV Edition",859,38000,61800,54660,5,2,toshiba_55_fire_tv_edition-10,227,7140
"Toshiba 55"" Fire TV Edition",238,38400,63000,50085,3,5,toshiba_55_fire_tv_edition-11,228,12915
"Toshiba 55"" Fire TV Edition",722,39600,65400,45276,1,3,toshiba_55_fire_tv_edition-12,229,20124
"Toshiba 55"" Fire TV Edition",184,39200,66600,46872,1,2,toshiba_55_fire_tv_edition-13,230,19728
"Toshiba 55"" Fire TV Edition",954,34000,60600,46635,3,5,toshiba_55_fire_tv_edition-14,231,13965
"Toshiba 55"" Fire TV Edition",804,36800,66000,39720,1,5,toshiba_55_fire_tv_edition-15,232,26280
"Toshiba 55"" Fire TV Edition",212,37200,69000,59460,4,2,toshiba_55_fire_tv_edition-16,233,9540
"Toshiba 55"" Fire TV Edition",669,34800,63600,50496,3,3,toshiba_55_fire_tv_edition-17,234,13104
"Toshiba 55"" Fire TV Edition",822,35200,63000,55355,5,1,toshiba_55_fire_tv_edition-18,235,7645
"Toshiba 55"" Fire TV Edition",259,37600,60600,50940,3,2,toshiba_55_fire_tv_edition-19,236,9660
"Toshiba 55"" Fire TV Edition",688,39200,63000,53004,3,2,toshiba_55_fire_tv_edition-20,237,9996
"Toshiba 55"" Fire TV Edition",549,38400,64200,57105,5,1,toshiba_55_fire_tv_edition-21,238,7095
"Toshiba 55"" Fire TV Edition",305,39600,63600,52680,3,3,toshiba_55_fire_tv_edition-22,239,10920
"Toshiba 55"" Fire TV Edition",361,37600,68400,56542,3,1,toshiba_55_fire_tv_edition-23,240,11858
"Toshiba 55"" Fire TV Edition",595,34800,60600,52860,5,2,toshiba_55_fire_tv_edition-24,241,7740
"Toshiba 55"" Fire TV Edition",878,34000,60600,39852,1,3,toshiba_55_fire_tv_edition-25,242,20748
"Toshiba 55"" Fire TV Edition",108,34000,61200,52360,5,3,toshiba_55_fire_tv_edition-26,243,8840
"Toshiba 55"" Fire TV Edition",461,36400,66600,55275,5,5,toshiba_55_fire_tv_edition-27,244,11325
"Samsung 75"" QLED 8K TV",84,97000,168000,146700,5,2,samsung_75_qled_8k_tv-0,245,21300
"Samsung 75"" QLED 8K TV",907,92000,169500,127650,2,2,samsung_75_qled_8k_tv-1,246,41850
"Samsung 75"" QLED 8K TV",302,94000,157500,138450,4,2,samsung_75_qled_8k_tv-2,247,19050
"Samsung 75"" QLED 8K TV",35,89000,163500,105390,1,3,samsung_75_qled_8k_tv-3,248,58110
"Samsung 75"" QLED 8K TV",516,86000,166500,115785,2,4,samsung_75_qled_8k_tv-4,249,50715
"Samsung 75"" QLED 8K TV",801,93000,163500,100050,1,5,samsung_75_qled_8k_tv-5,250,63450
"Samsung 75"" QLED 8K TV",836,93000,151500,129563,5,5,samsung_75_qled_8k_tv-6,251,21937
"Samsung 75"" QLED 8K TV",862,87000,160500,114195,2,4,samsung_75_qled_8k_tv-7,252,46305
"Samsung 75"" QLED 8K TV",457,98000,171000,132675,3,5,samsung_75_qled_8k_tv-8,253,38325
"Samsung 75"" QLED 8K TV",821,87000,154500,134250,4,2,samsung_75_qled_8k_tv-9,254,20250
"Samsung 75"" QLED 8K TV",47,85000,162000,136975,4,3,samsung_75_qled_8k_tv-10,255,25025
"Samsung 75"" QLED 8K TV",586,92000,156000,126880,3,3,samsung_75_qled_8k_tv-11,256,29120
"Samsung 75"" QLED 8K TV",965,97000,168000,135695,3,3,samsung_75_qled_8k_tv-12,257,32305
"Samsung 75"" QLED 8K TV",60,92000,172500,119370,1,1,samsung_75_qled_8k_tv-13,258,53130
"Samsung 75"" QLED 8K TV",186,86000,171000,135300,3,2,samsung_75_qled_8k_tv-14,259,35700
"Samsung 75"" QLED 8K TV",502,91000,168000,138355,3,1,samsung_75_qled_8k_tv-15,260,29645
"Samsung 75"" QLED 8K TV",885,97000,151500,114713,2,5,samsung_75_qled_8k_tv-16,261,36787
"Samsung 75"" QLED 8K TV",662,95000,157500,133438,3,1,samsung_75_qled_8k_tv-17,262,24062
"Samsung 75"" QLED 8K TV",687,87000,157500,130358,3,1,samsung_75_qled_8k_tv-18,263,27142
"Samsung 75"" QLED 8K TV",787,96000,151500,136238,5,1,samsung_75_qled_8k_tv-19,264,15262
"Samsung 75"" QLED 8K TV",468,93000,165000,143400,5,2,samsung_75_qled_8k_tv-20,265,21600
"LG 55"" NanoCell 4K TV",207,48400,91575,79702,5,1,lg_55_nanocell_4k_tv-0,266,11873
"LG 55"" NanoCell 4K TV",597,52250,83325,74780,4,1,lg_55_nanocell_4k_tv-1,267,8545
"LG 55"" NanoCell 4K TV",106,53900,84150,73563,5,4,lg_55_nanocell_4k_tv-2,268,10587
"LG 55"" NanoCell 4K TV",646,51700,87450,74938,4,4,lg_55_nanocell_4k_tv-3,269,12512
"LG 55"" NanoCell 4K TV",567,50050,89925,68991,3,5,lg_55_nanocell_4k_tv-4,270,20934
"LG 55"" NanoCell 4K TV",42,54450,94875,63344,1,3,lg_55_nanocell_4k_tv-5,271,31531
"LG 55"" NanoCell 4K TV",281,52800,84150,67221,2,2,lg_55_nanocell_4k_tv-6,272,16929
"LG 55"" NanoCell 4K TV",381,51150,85800,67609,3,5,lg_55_nanocell_4k_tv-7,273,18191
"LG 55"" NanoCell 4K TV",252,52800,88275,74972,5,5,lg_55_nanocell_4k_tv-8,274,13303
"LG 55"" NanoCell 4K TV",628,47850,84975,71054,4,5,lg_55_nanocell_4k_tv-9,275,13921
"LG 55"" NanoCell 4K TV",878,48400,94875,78609,5,4,lg_55_nanocell_4k_tv-10,276,16266
"LG 55"" NanoCell 4K TV",48,53350,93225,80266,4,3,lg_55_nanocell_4k_tv-11,277,12959
"LG 55"" NanoCell 4K TV",642,53900,84975,69593,2,1,lg_55_nanocell_4k_tv-12,278,15382
"LG 55"" NanoCell 4K TV",166,54450,83325,68166,3,5,lg_55_nanocell_4k_tv-13,279,15159
"LG 55"" NanoCell 4K TV",685,50600,85800,56232,1,4,lg_55_nanocell_4k_tv-14,280,29568
"LG 55"" NanoCell 4K TV",725,54450,85800,69342,3,5,lg_55_nanocell_4k_tv-15,281,16458
"LG 55"" NanoCell 4K TV",473,54450,83325,75385,5,1,lg_55_nanocell_4k_tv-16,282,7940
"LG 55"" NanoCell 4K TV",264,54450,84975,76581,5,1,lg_55_nanocell_4k_tv-17,283,8394
"LG 55"" NanoCell 4K TV",881,51700,89100,76010,5,4,lg_55_nanocell_4k_tv-18,284,13090
"LG 55"" NanoCell 4K TV",186,47300,93225,78300,5,3,lg_55_nanocell_4k_tv-19,285,14925
"LG 55"" NanoCell 4K TV",404,52250,84150,65489,2,3,lg_55_nanocell_4k_tv-20,286,18661
"LG 55"" NanoCell 4K TV",190,53350,91575,71507,3,5,lg_55_nanocell_4k_tv-21,287,20068
"LG 55"" NanoCell 4K TV",688,53350,94875,77435,3,2,lg_55_nanocell_4k_tv-22,288,17440
"Sony 65"" 4K HDR Android TV",694,60900,120750,88431,2,2,sony_65_4k_hdr_android_tv-0,289,32319
"Sony 65"" 4K HDR Android TV",198,60200,108150,94964,5,1,sony_65_4k_hdr_android_tv-1,290,13186
"Sony 65"" 4K HDR Android TV",721,63000,108150,84447,3,5,sony_65_4k_hdr_android_tv-2,291,23703
"Sony 65"" 4K HDR Android TV",77,62300,114450,67515,1,5,sony_65_4k_hdr_android_tv-3,292,46935
"Sony 65"" 4K HDR Android TV",853,60900,106050,83701,2,1,sony_65_4k_hdr_android_tv-4,293,22349
"Sony 65"" 4K HDR Android TV",523,63700,106050,77464,2,5,sony_65_4k_hdr_android_tv-5,294,28586
"Sony 65"" 4K HDR Android TV",82,61600,120750,88809,2,2,sony_65_4k_hdr_android_tv-6,295,31941
"Sony 65"" 4K HDR Android TV",900,66500,109200,97458,4,1,sony_65_4k_hdr_android_tv-7,296,11742
"Sony 65"" 4K HDR Android TV",360,61600,106050,90493,5,4,sony_65_4k_hdr_android_tv-8,297,15557
"Sony 65"" 4K HDR Android TV",419,62300,107100,77532,1,1,sony_65_4k_hdr_android_tv-9,298,29568
"Sony 65"" 4K HDR Android TV",830,61600,108150,80919,2,3,sony_65_4k_hdr_android_tv-10,299,27231
"Sony 65"" 4K HDR Android TV",868,67900,115500,83370,2,5,sony_65_4k_hdr_android_tv-11,300,32130
"Sony 65"" 4K HDR Android TV",644,60200,117600,81438,2,4,sony_65_4k_hdr_android_tv-12,301,36162
"Sony 65"" 4K HDR Android TV",344,67200,107100,73584,1,4,sony_65_4k_hdr_android_tv-13,302,33516
"Sony 65"" 4K HDR Android TV",251,63700,111300,74172,1,3,sony_65_4k_hdr_android_tv-14,303,37128
"Sony 65"" 4K HDR Android TV",379,67900,107100,76524,1,3,sony_65_4k_hdr_android_tv-15,304,30576
"Sony 65"" 4K HDR Android TV",442,65800,116550,101325,4,2,sony_65_4k_hdr_android_tv-16,305,15225
"Sony 65"" 4K HDR Android TV",551,62300,118650,74697,1,3,sony_65_4k_hdr_android_tv-17,306,43953
"Sony 65"" 4K HDR Android TV",187,67900,119700,92505,3,5,sony_65_4k_hdr_android_tv-18,307,27195
"Sony 65"" 4K HDR Android TV",767,64400,113400,72240,1,4,sony_65_4k_hdr_android_tv-19,308,41160
"Sony 65"" 4K HDR Android TV",636,64400,117600,76104,1,3,sony_65_4k_hdr_android_tv-20,309,41496
"Sony 65"" 4K HDR Android TV",298,67200,116550,90642,3,5,sony_65_4k_hdr_android_tv-21,310,25908
"Sony 65"" 4K HDR Android TV",194,62300,115500,89166,2,1,sony_65_4k_hdr_android_tv-22,311,26334
"Sony 65"" 4K HDR Android TV",228,65800,115500,94626,3,2,sony_65_4k_hdr_android_tv-23,312,20874
"TCL 55"" QLED 4K Android TV",80,72000,129375,90647,2,5,tcl_55_qled_4k_android_tv-0,313,38728
"TCL 55"" QLED 4K Android TV",360,69000,120375,86468,1,1,tcl_55_qled_4k_android_tv-1,314,33907
"TCL 55"" QLED 4K Android TV",625,72000,121500,105413,5,3,tcl_55_qled_4k_android_tv-2,315,16087
"TCL 55"" QLED 4K Android TV",704,70500,113625,100688,4,2,tcl_55_qled_4k_android_tv-3,316,12937
"TCL 55"" QLED 4K Android TV",819,69750,120375,103922,5,3,tcl_55_qled_4k_android_tv-4,317,16453
"TCL 55"" QLED 4K Android TV",41,69750,128250,94028,2,3,tcl_55_qled_4k_android_tv-5,318,34222
"TCL 55"" QLED 4K Android TV",341,64500,118125,69863,1,5,tcl_55_qled_4k_android_tv-6,319,48262
"TCL 55"" QLED 4K Android TV",428,69000,117000,93480,3,4,tcl_55_qled_4k_android_tv-7,320,23520
"TCL 55"" QLED 4K Android TV",346,66000,124875,87784,2,4,tcl_55_qled_4k_android_tv-8,321,37091
"TCL 55"" QLED 4K Android TV",866,73500,118125,99383,3,2,tcl_55_qled_4k_android_tv-9,322,18742
"TCL 55"" QLED 4K Android TV",270,74250,123750,105188,5,5,tcl_55_qled_4k_android_tv-10,323,18562
"TCL 55"" QLED 4K Android TV",704,70500,115875,83205,1,2,tcl_55_qled_4k_android_tv-11,324,32670
"TCL 55"" QLED 4K Android TV",443,72000,118125,79380,1,4,tcl_55_qled_4k_android_tv-12,325,38745
"TCL 55"" QLED 4K Android TV",845,73500,122625,107888,5,2,tcl_55_qled_4k_android_tv-13,326,14737
"TCL 55"" QLED 4K Android TV",84,72750,120375,102040,3,1,tcl_55_qled_4k_android_tv-14,327,18335
"TCL 55"" QLED 4K Android TV",779,67500,124875,103360,4,5,tcl_55_qled_4k_android_tv-15,328,21515
"TCL 55"" QLED 4K Android TV",592,66750,121500,100422,3,1,tcl_55_qled_4k_android_tv-16,329,21078
"TCL 55"" QLED 4K Android TV",483,69000,117000,79560,1,3,tcl_55_qled_4k_android_tv-17,330,37440
"TCL 55"" QLED 4K Android TV",681,67500,126000,109913,4,1,tcl_55_qled_4k_android_tv-18,331,16087
"TCL 55"" QLED 4K Android TV",608,65250,129375,105329,4,5,tcl_55_qled_4k_android_tv-19,332,24046
"TCL 55"" QLED 4K Android TV",165,66000,128250,109575,5,2,tcl_55_qled_4k_android_tv-20,333,18675
"TCL 55"" QLED 4K Android TV",52,72000,126000,109800,5,2,tcl_55_qled_4k_android_tv-21,334,16200
"TCL 55"" QLED 4K Android TV",762,63750,123750,107250,4,1,tcl_55_qled_4k_android_tv-22,335,16500
"TCL 55"" QLED 4K Android TV",993,63750,123750,102750,5,4,tcl_55_qled_4k_android_tv-23,336,21000
"TCL 55"" QLED 4K Android TV",446,70500,120375,94191,3,5,tcl_55_qled_4k_android_tv-24,337,26184
"Vizio 65"" P-Series Quantum TV",46,77600,132000,105072,2,1,vizio_65_pseries_quantum_tv-0,338,26928
"Vizio 65"" P-Series Quantum TV",539,74400,127200,79680,1,5,vizio_65_pseries_quantum_tv-1,339,47520
"Vizio 65"" P-Series Quantum TV",186,71200,132000,113760,4,2,vizio_65_pseries_quantum_tv-2,340,18240
"Vizio 65"" P-Series Quantum TV",233,69600,121200,87144,1,1,vizio_65_pseries_quantum_tv-3,341,34056
"Vizio 65"" P-Series Quantum TV",754,76800,135600,113550,5,5,vizio_65_pseries_quantum_tv-4,342,22050
"Vizio 65"" P-Series Quantum TV",200,72000,123600,86448,1,2,vizio_65_pseries_quantum_tv-5,343,37152
"Vizio 65"" P-Series Quantum TV",583,79200,132000,101112,2,3,vizio_65_pseries_quantum_tv-6,344,30888
"Vizio 65"" P-Series Quantum TV",755,74400,121200,108330,4,1,vizio_65_pseries_quantum_tv-7,345,12870
"Vizio 65"" P-Series Quantum TV",458,79200,123600,111390,5,1,vizio_65_pseries_quantum_tv-8,346,12210
"Vizio 65"" P-Series Quantum TV",401,72000,138000,114900,5,4,vizio_65_pseries_quantum_tv-9,347,23100
"Vizio 65"" P-Series Quantum TV",667,70400,134400,102720,2,1,vizio_65_pseries_quantum_tv-10,348,31680
"Vizio 65"" P-Series Quantum TV",70,78400,132000,90192,1,3,vizio_65_pseries_quantum_tv-11,349,41808
"Vizio 65"" P-Series Quantum TV",436,76000,132000,116600,4,1,vizio_65_pseries_quantum_tv-12,350,15400
"Vizio 65"" P-Series Quantum TV",932,68800,136800,108240,3,2,vizio_65_pseries_quantum_tv-13,351,28560
"Vizio 65"" P-Series Quantum TV",978,71200,127200,105640,3,1,vizio_65_pseries_quantum_tv-14,352,21560
"Vizio 65"" P-Series Quantum TV",919,72800,126000,97272,2,2,vizio_65_pseries_quantum_tv-15,353,28728
"Vizio 65"" P-Series Quantum TV",916,74400,129600,83232,1,4,vizio_65_pseries_quantum_tv-16,354,46368
"Vizio 65"" P-Series Quantum TV",726,78400,126000,93870,2,5,vizio_65_pseries_quantum_tv-17,355,32130
"Vizio 65"" P-Series Quantum TV",898,77600,130800,112180,4,4,vizio_65_pseries_quantum_tv-18,356,18620
"Vizio 65"" P-Series Quantum TV",136,79200,122400,110520,5,1,vizio_65_pseries_quantum_tv-19,357,11880
"Vizio 65"" P-Series Quantum TV",280,72000,121200,90204,2,4,vizio_65_pseries_quantum_tv-20,358,30996
"Vizio 65"" P-Series Quantum TV",844,70400,135600,88656,1,2,vizio_65_pseries_quantum_tv-21,359,46944
"Vizio 65"" P-Series Quantum TV",586,70400,134400,112000,4,4,vizio_65_pseries_quantum_tv-22,360,22400
"Vizio 65"" P-Series Quantum TV",290,72800,127200,81504,1,4,vizio_65_pseries_quantum_tv-23,361,45696
"Vizio 65"" P-Series Quantum TV",517,76000,130800,114360,4,2,vizio_65_pseries_quantum_tv-24,362,16440
"Vizio 65"" P-Series Quantum TV",33,68000,133200,108750,5,5,vizio_65_pseries_quantum_tv-25,363,24450
"Vizio 65"" P-Series Quantum TV",405,75200,132000,112120,4,4,vizio_65_pseries_quantum_tv-26,364,19880
"Vizio 65"" P-Series Quantum TV",851,78400,123600,99192,2,2,vizio_65_pseries_quantum_tv-27,365,24408
"Vizio 65"" P-Series Quantum TV",933,70400,124800,97872,2,1,vizio_65_pseries_quantum_tv-28,366,26928
"Vizio 65"" P-Series Quantum TV",803,69600,132000,75840,1,5,vizio_65_pseries_quantum_tv-29,367,56160
"Hisense 50"" 4K Roku TV",775,34000,68400,56360,4,4,hisense_50_4k_roku_tv-0,368,12040
"Hisense 50"" 4K Roku TV",342,36000,67200,51756,2,1,hisense_50_4k_roku_tv-1,369,15444
"Hisense 50"" 4K Roku TV",294,37200,65400,47634,2,4,hisense_50_4k_roku_tv-2,370,17766
"Hisense 50"" 4K Roku TV",537,38400,63000,55620,5,2,hisense_50_4k_roku_tv-3,371,7380
"Hisense 50"" 4K Roku TV",958,38000,61800,41808,1,4,hisense_50_4k_roku_tv-4,372,19992
"Hisense 50"" 4K Roku TV",268,34000,61200,53040,4,2,hisense_50_4k_roku_tv-5,373,8160
"Hisense 50"" 4K Roku TV",166,39200,65400,41820,1,5,hisense_50_4k_roku_tv-6,374,23580
"Hisense 50"" 4K Roku TV",479,39600,63000,52353,3,3,hisense_50_4k_roku_tv-7,375,10647
"Hisense 50"" 4K Roku TV",723,36400,67200,52108,3,4,hisense_50_4k_roku_tv-8,376,15092
"Hisense 50"" 4K Roku TV",885,35200,67200,55200,5,5,hisense_50_4k_roku_tv-9,377,12000
"Hisense 50"" 4K Roku TV",569,37200,67200,55650,3,1,hisense_50_4k_roku_tv-10,378,11550
"Hisense 50"" 4K Roku TV",251,37600,60600,48180,2,2,hisense_50_4k_roku_tv-11,379,12420
"Hisense 50"" 4K Roku TV",235,38800,63600,56160,5,2,hisense_50_4k_roku_tv-12,380,7440
"Hisense 50"" 4K Roku TV",45,35600,64200,54190,5,4,hisense_50_4k_roku_tv-13,381,10010
"Hisense 50"" 4K Roku TV",206,36400,67200,47796,2,4,hisense_50_4k_roku_tv-14,382,19404
"Hisense 50"" 4K Roku TV",867,36800,67800,47340,1,1,hisense_50_4k_roku_tv-15,383,20460
"Hisense 50"" 4K Roku TV",287,34000,64800,55560,5,2,hisense_50_4k_roku_tv-16,384,9240
"Hisense 50"" 4K Roku TV",718,35600,63600,53800,5,4,hisense_50_4k_roku_tv-17,385,9800
"Hisense 50"" 4K Roku TV",816,38800,69000,51333,2,3,hisense_50_4k_roku_tv-18,386,17667
"Hisense 50"" 4K Roku TV",684,36400,62400,46020,2,4,hisense_50_4k_roku_tv-19,387,16380
"Hisense 50"" 4K Roku TV",51,36400,66000,47352,2,4,hisense_50_4k_roku_tv-20,388,18648
"Philips 55"" 4K Android TV",836,56400,91800,81180,5,2,philips_55_4k_android_tv-0,389,10620
"Philips 55"" 4K Android TV",590,56400,99000,78126,3,4,philips_55_4k_android_tv-1,390,20874
"Philips 55"" 4K Android TV",93,57000,93600,74385,3,5,philips_55_4k_android_tv-2,391,19215
"Philips 55"" 4K Android TV",218,55200,96300,84998,5,1,philips_55_4k_android_tv-3,392,11302
"Philips 55"" 4K Android TV",891,57000,103500,89550,4,2,philips_55_4k_android_tv-4,393,13950
"Philips 55"" 4K Android TV",522,59400,97200,84915,5,3,philips_55_4k_android_tv-5,394,12285
"Philips 55"" 4K Android TV",764,54600,97200,79308,3,2,philips_55_4k_android_tv-6,395,17892
"Philips 55"" 4K Android TV",584,51600,96300,72162,2,2,philips_55_4k_android_tv-7,396,24138
"Philips 55"" 4K Android TV",517,57600,97200,83340,4,4,philips_55_4k_android_tv-8,397,13860
"Philips 55"" 4K Android TV",743,53400,102600,89070,5,1,philips_55_4k_android_tv-9,398,13530
"Philips 55"" 4K Android TV",956,53400,97200,80775,5,5,philips_55_4k_android_tv-10,399,16425
"Philips 55"" 4K Android TV",218,59400,94500,71334,1,1,philips_55_4k_android_tv-11,400,23166
"Philips 55"" 4K Android TV",184,58800,96300,85050,5,2,philips_55_4k_android_tv-12,401,11250
"Philips 55"" 4K Android TV",213,51600,93600,65250,2,5,philips_55_4k_android_tv-13,402,28350
"Philips 55"" 4K Android TV",724,56400,91800,75693,3,3,philips_55_4k_android_tv-14,403,16107
"Philips 55"" 4K Android TV",576,54600,102600,85800,5,4,philips_55_4k_android_tv-15,404,16800
"Philips 55"" 4K Android TV",647,53400,98100,81338,5,5,philips_55_4k_android_tv-16,405,16762
"Philips 55"" 4K Android TV",655,51600,99000,85965,5,1,philips_55_4k_android_tv-17,406,13035
"Philips 55"" 4K Android TV",768,52800,90900,78518,5,3,philips_55_4k_android_tv-18,407,12382
"Philips 55"" 4K Android TV",477,54600,103500,62424,1,4,philips_55_4k_android_tv-19,408,41076
"Philips 55"" 4K Android TV",443,52200,103500,71181,2,4,philips_55_4k_android_tv-20,409,32319
"Philips 55"" 4K Android TV",414,55200,94500,68562,1,1,philips_55_4k_android_tv-21,410,25938
"Philips 55"" 4K Android TV",55,58200,92700,79763,5,5,philips_55_4k_android_tv-22,411,12937
"Philips 55"" 4K Android TV",84,55800,102600,85050,4,5,philips_55_4k_android_tv-23,412,17550
"Philips 55"" 4K Android TV",341,55200,98100,75578,3,5,philips_55_4k_android_tv-24,413,22522
"Philips 55"" 4K Android TV",769,59400,97200,72252,1,1,philips_55_4k_android_tv-25,414,24948
"Panasonic 58"" 4K HDR TV",240,55900,104325,85682,3,1,panasonic_58_4k_hdr_tv-0,415,18643
"Panasonic 58"" 4K HDR TV",741,61100,111150,84123,2,2,panasonic_58_4k_hdr_tv-1,416,27027
"Panasonic 58"" 4K HDR TV",124,55250,108225,74851,2,4,panasonic_58_4k_hdr_tv-2,417,33374
"Panasonic 58"" 4K HDR TV",716,56550,106275,92601,5,1,panasonic_58_4k_hdr_tv-3,418,13674
"Panasonic 58"" 4K HDR TV",611,59150,99450,82524,3,2,panasonic_58_4k_hdr_tv-4,419,16926
"Panasonic 58"" 4K HDR TV",746,64350,109200,88794,3,3,panasonic_58_4k_hdr_tv-5,420,20406
"Panasonic 58"" 4K HDR TV",74,64350,104325,86137,3,3,panasonic_58_4k_hdr_tv-6,421,18188
"Panasonic 58"" 4K HDR TV",952,60450,98475,85167,4,4,panasonic_58_4k_hdr_tv-7,422,13308
"Panasonic 58"" 4K HDR TV",872,56550,107250,80633,3,5,panasonic_58_4k_hdr_tv-8,423,26617
"Panasonic 58"" 4K HDR TV",126,59800,102375,80024,3,5,panasonic_58_4k_hdr_tv-9,424,22351
"Panasonic 58"" 4K HDR TV",781,55250,112125,96485,4,1,panasonic_58_4k_hdr_tv-10,425,15640
"Panasonic 58"" 4K HDR TV",90,57200,105300,77162,2,3,panasonic_58_4k_hdr_tv-11,426,28138
"Panasonic 58"" 4K HDR TV",897,58500,109200,93990,4,2,panasonic_58_4k_hdr_tv-12,427,15210
"Panasonic 58"" 4K HDR TV",819,63050,106275,91147,4,4,panasonic_58_4k_hdr_tv-13,428,15128
"Panasonic 58"" 4K HDR TV",23,60450,107250,81978,2,2,panasonic_58_4k_hdr_tv-14,429,25272
"Panasonic 58"" 4K HDR TV",364,55900,105300,81094,3,4,panasonic_58_4k_hdr_tv-15,430,24206
"Panasonic 58"" 4K HDR TV",228,63700,99450,73710,1,2,panasonic_58_4k_hdr_tv-16,431,25740
"Panasonic 58"" 4K HDR TV",464,55250,109200,80877,3,5,panasonic_58_4k_hdr_tv-17,432,28323
"Panasonic 58"" 4K HDR TV",827,59150,106275,82949,2,1,panasonic_58_4k_hdr_tv-18,433,23326
"Panasonic 58"" 4K HDR TV",40,64350,108225,92869,5,4,panasonic_58_4k_hdr_tv-19,434,15356
"Panasonic 58"" 4K HDR TV",662,59800,103350,71994,1,2,panasonic_58_4k_hdr_tv-20,435,31356
"Panasonic 58"" 4K HDR TV",772,63050,104325,82656,3,5,panasonic_58_4k_hdr_tv-21,436,21669
"Panasonic 58"" 4K HDR TV",417,61750,108225,94283,4,2,panasonic_58_4k_hdr_tv-22,437,13942
"Panasonic 58"" 4K HDR TV",888,57850,109200,95079,4,1,panasonic_58_4k_hdr_tv-23,438,14121
"Panasonic 58"" 4K HDR TV",264,61750,101400,89505,4,2,panasonic_58_4k_hdr_tv-24,439,11895
"Sharp 65"" 4K Aquos TV",297,65800,116550,84578,2,4,sharp_65_4k_aquos_tv-0,440,31972
"Sharp 65"" 4K Aquos TV",993,59500,108150,93555,5,2,sharp_65_4k_aquos_tv-1,441,14595
"Sharp 65"" 4K Aquos TV",448,65800,112350,92799,3,2,sharp_65_4k_aquos_tv-2,442,19551
"Sharp 65"" 4K Aquos TV",839,65100,112350,95813,4,4,sharp_65_4k_aquos_tv-3,443,16537
"Sharp 65"" 4K Aquos TV",175,66500,118650,101702,4,3,sharp_65_4k_aquos_tv-4,444,16948
"Sharp 65"" 4K Aquos TV",473,63700,119700,76020,1,3,sharp_65_4k_aquos_tv-5,445,43680
"Sharp 65"" 4K Aquos TV",785,60200,112350,86797,3,4,sharp_65_4k_aquos_tv-6,446,25553
"Sharp 65"" 4K Aquos TV",691,66500,118650,71715,1,5,sharp_65_4k_aquos_tv-7,447,46935
"Sharp 65"" 4K Aquos TV",751,67200,110250,95183,4,4,sharp_65_4k_aquos_tv-8,448,15067
"Sharp 65"" 4K Aquos TV",903,63700,111300,98210,4,1,sharp_65_4k_aquos_tv-9,449,13090
"Sharp 65"" 4K Aquos TV",759,62300,110250,90111,3,2,sharp_65_4k_aquos_tv-10,450,20139
"Sharp 65"" 4K Aquos TV",607,63000,114450,100302,5,1,sharp_65_4k_aquos_tv-11,451,14148
"Sharp 65"" 4K Aquos TV",361,64400,106050,73563,1,3,sharp_65_4k_aquos_tv-12,452,32487
"Sharp 65"" 4K Aquos TV",407,60900,106050,76251,1,1,sharp_65_4k_aquos_tv-13,453,29799
"Sharp 65"" 4K Aquos TV",439,61600,120750,81711,1,1,sharp_65_4k_aquos_tv-14,454,39039
"Sharp 65"" 4K Aquos TV",617,67200,118650,93183,2,1,sharp_65_4k_aquos_tv-15,455,25467
"Sharp 65"" 4K Aquos TV",122,61600,116550,73689,1,3,sharp_65_4k_aquos_tv-16,456,42861
"Sharp 65"" 4K Aquos TV",911,63700,107100,90825,4,5,sharp_65_4k_aquos_tv-17,457,16275
"Sharp 65"" 4K Aquos TV",166,59500,111300,93170,5,4,sharp_65_4k_aquos_tv-18,458,18130
"Sharp 65"" 4K Aquos TV",91,60200,120750,90778,2,1,sharp_65_4k_aquos_tv-19,459,29972
"Toshiba 43"" HD Smart TV",101,27600,46350,38475,3,2,toshiba_43_hd_smart_tv-0,460,7875
"Toshiba 43"" HD Smart TV",442,26400,45450,36783,3,3,toshiba_43_hd_smart_tv-1,461,8667
"Toshiba 43"" HD Smart TV",834,29700,49050,36860,2,4,toshiba_43_hd_smart_tv-2,462,12190
"Toshiba 43"" HD Smart TV",41,27900,50400,43088,5,3,toshiba_43_hd_smart_tv-3,463,7312
"Toshiba 43"" HD Smart TV",603,28500,50850,40681,3,3,toshiba_43_hd_smart_tv-4,464,10169
"Toshiba 43"" HD Smart TV",986,25500,47700,39930,4,4,toshiba_43_hd_smart_tv-5,465,7770
"Toshiba 43"" HD Smart TV",633,28500,48600,37746,2,2,toshiba_43_hd_smart_tv-6,466,10854
"Toshiba 43"" HD Smart TV",635,25500,49050,27855,1,5,toshiba_43_hd_smart_tv-7,467,21195
"Toshiba 43"" HD Smart TV",536,28200,45450,40275,4,2,toshiba_43_hd_smart_tv-8,468,5175
"Toshiba 43"" HD Smart TV",284,27600,47700,38555,3,3,toshiba_43_hd_smart_tv-9,469,9145
"Toshiba 43"" HD Smart TV",732,28200,45450,38982,5,5,toshiba_43_hd_smart_tv-10,470,6468
"Toshiba 43"" HD Smart TV",346,28500,50400,39669,3,4,toshiba_43_hd_smart_tv-11,471,10731
"Toshiba 43"" HD Smart TV",239,28500,46350,40103,5,4,toshiba_43_hd_smart_tv-12,472,6247
"Toshiba 43"" HD Smart TV",250,25500,48150,39657,4,5,toshiba_43_hd_smart_tv-13,473,8493
"Toshiba 43"" HD Smart TV",652,25500,48150,33201,1,1,toshiba_43_hd_smart_tv-14,474,14949
"Toshiba 43"" HD Smart TV",475,28500,50400,42735,4,4,toshiba_43_hd_smart_tv-15,475,7665
"Toshiba 43"" HD Smart TV",156,27900,45450,38869,5,5,toshiba_43_hd_smart_tv-16,476,6581
"Toshiba 43"" HD Smart TV",813,27300,49050,40677,3,1,toshiba_43_hd_smart_tv-17,477,8373
"Toshiba 43"" HD Smart TV",52,29400,45900,32040,1,4,toshiba_43_hd_smart_tv-18,478,13860
"Toshiba 43"" HD Smart TV",327,25500,45900,27540,1,5,toshiba_43_hd_smart_tv-19,479,18360
"Toshiba 43"" HD Smart TV",596,26400,49950,30168,1,4,toshiba_43_hd_smart_tv-20,480,19782
"Toshiba 43"" HD Smart TV",656,27300,48600,34542,1,1,toshiba_43_hd_smart_tv-21,481,14058
"Toshiba 43"" HD Smart TV",55,27300,47250,41764,4,1,toshiba_43_hd_smart_tv-22,482,5486
"Toshiba 43"" HD Smart TV",355,28200,49950,38205,2,2,toshiba_43_hd_smart_tv-23,483,11745
"Toshiba 43"" HD Smart TV",831,29400,49500,41762,3,1,toshiba_43_hd_smart_tv-24,484,7738
"Toshiba 43"" HD Smart TV",226,25500,49950,37114,3,5,toshiba_43_hd_smart_tv-25,485,12836
"Toshiba 43"" HD Smart TV",187,29100,50850,42694,4,5,toshiba_43_hd_smart_tv-26,486,8156
"Toshiba 43"" HD Smart TV",733,29100,48150,39483,3,3,toshiba_43_hd_smart_tv-27,487,8667
"Toshiba 43"" HD Smart TV",658,27000,45450,39915,5,2,toshiba_43_hd_smart_tv-28,488,5535
Organic Avocado,850,46,79,70,4,1,organic_avocado-0,489,9
Organic Avocado,231,49,86,68,2,1,organic_avocado-1,490,18
Organic Avocado,240,49,86,73,4,5,organic_avocado-2,491,13
Organic Avocado,704,48,76,62,3,5,organic_avocado-3,492,14
Organic Avocado,346,46,79,68,4,4,organic_avocado-4,493,11
Organic Avocado,624,47,79,59,2,4,organic_avocado-5,494,20
Organic Avocado,680,45,81,72,5,1,organic_avocado-6,495,9
Organic Avocado,976,47,81,67,3,2,organic_avocado-7,496,14
Organic Avocado,961,46,75,66,5,3,organic_avocado-8,497,9
Organic Avocado,986,47,86,51,1,5,organic_avocado-9,498,35
Organic Avocado,767,43,78,65,5,5,organic_avocado-10,499,13
Organic Avocado,414,47,79,58,2,5,organic_avocado-11,500,21
Organic Avocado,576,44,80,64,3,3,organic_avocado-12,501,16
Organic Avocado,33,50,81,71,5,4,organic_avocado-13,502,10
Organic Avocado,101,47,77,56,1,2,organic_avocado-14,503,21
Organic Avocado,193,47,80,69,4,4,organic_avocado-15,504,11
Organic Avocado,805,48,83,71,4,4,organic_avocado-16,505,12
Organic Avocado,553,49,84,62,2,4,organic_avocado-17,506,22
Organic Avocado,62,47,85,65,2,2,organic_avocado-18,507,20
Organic Avocado,690,47,84,73,4,2,organic_avocado-19,508,11
Organic Avocado,679,47,76,58,2,4,organic_avocado-20,509,18
Organic Avocado,941,50,83,64,2,3,organic_avocado-21,510,19
Organic Avocado,95,47,86,56,1,3,organic_avocado-22,511,30
Organic Avocado,982,49,84,66,2,2,organic_avocado-23,512,18
Organic Avocado,354,46,83,67,3,3,organic_avocado-24,513,16
Organic Avocado,752,46,75,60,3,5,organic_avocado-25,514,15
Organic Avocado,447,47,81,70,4,4,organic_avocado-26,515,11
Organic Avocado,112,50,86,71,3,2,organic_avocado-27,516,15
Organic Avocado,914,49,79,71,4,1,organic_avocado-28,517,8
Organic Avocado,769,48,76,69,5,1,organic_avocado-29,518,7
Whole Wheat Bread,226,38,67,52,2,2,whole_wheat_bread-0,519,15
Whole Wheat Bread,962,36,65,50,3,5,whole_wheat_bread-1,520,15
Whole Wheat Bread,366,34,63,48,2,2,whole_wheat_bread-2,521,15
Whole Wheat Bread,776,38,65,52,3,4,whole_wheat_bread-3,522,13
Whole Wheat Bread,551,38,64,48,2,4,whole_wheat_bread-4,523,16
Whole Wheat Bread,880,37,69,52,2,2,whole_wheat_bread-5,524,17
Whole Wheat Bread,222,40,66,59,4,1,whole_wheat_bread-6,525,7
Whole Wheat Bread,111,35,64,48,2,3,whole_wheat_bread-7,526,16
Whole Wheat Bread,116,34,69,60,4,1,whole_wheat_bread-8,527,9
Whole Wheat Bread,651,38,60,54,5,1,whole_wheat_bread-9,528,6
Whole Wheat Bread,147,37,67,47,2,5,whole_wheat_bread-10,529,20
Whole Wheat Bread,999,39,65,51,2,2,whole_wheat_bread-11,530,14
Whole Wheat Bread,352,36,63,53,4,5,whole_wheat_bread-12,531,10
Whole Wheat Bread,737,39,66,49,2,4,whole_wheat_bread-13,532,17
Whole Wheat Bread,571,39,69,42,1,5,whole_wheat_bread-14,533,27
Whole Wheat Bread,371,37,62,56,4,1,whole_wheat_bread-15,534,6
Whole Wheat Bread,86,34,66,55,5,4,whole_wheat_bread-16,535,11
Whole Wheat Bread,676,39,63,54,5,5,whole_wheat_bread-17,536,9
Whole Wheat Bread,880,36,65,52,3,3,whole_wheat_bread-18,537,13
Whole Wheat Bread,312,35,63,43,1,2,whole_wheat_bread-19,538,20
Whole Wheat Bread,657,40,67,53,3,5,whole_wheat_bread-20,539,14
Organic Eggs,603,65,115,88,2,2,organic_eggs-0,540,27
Organic Eggs,473,64,107,84,2,2,organic_eggs-1,541,23
Organic Eggs,530,67,109,96,4,3,organic_eggs-2,542,13
Organic Eggs,663,63,113,87,3,5,organic_eggs-3,543,26
Organic Eggs,842,67,110,94,3,1,organic_eggs-4,544,16
Organic Eggs,319,60,119,73,1,3,organic_eggs-5,545,46
Organic Eggs,76,66,111,83,2,4,organic_eggs-6,546,28
Organic Eggs,984,67,115,101,4,2,organic_eggs-7,547,14
Organic Eggs,505,63,114,90,3,4,organic_eggs-8,548,24
Organic Eggs,296,61,110,82,2,3,organic_eggs-9,549,28
Organic Eggs,671,61,116,79,2,5,organic_eggs-10,550,37
Organic Eggs,93,69,106,94,5,4,organic_eggs-11,551,12
Organic Eggs,591,61,119,89,3,5,organic_eggs-12,552,30
Organic Eggs,806,66,107,80,2,5,organic_eggs-13,553,27
Organic Eggs,497,64,113,95,5,5,organic_eggs-14,554,18
Organic Eggs,98,65,118,103,5,2,organic_eggs-15,555,15
Organic Eggs,414,68,119,85,2,5,organic_eggs-16,556,34
Organic Eggs,236,63,118,101,5,3,organic_eggs-17,557,17
Organic Eggs,558,64,115,99,5,3,organic_eggs-18,558,16
Organic Eggs,300,64,120,102,4,3,organic_eggs-19,559,18
Organic Eggs,460,66,118,98,3,1,organic_eggs-20,560,20
Organic Eggs,157,69,116,93,2,1,organic_eggs-21,561,23
Almond Milk,474,29,49,42,5,4,almond_milk-0,562,7
Almond Milk,152,27,45,37,3,4,almond_milk-1,563,8
Almond Milk,459,27,49,42,5,4,almond_milk-2,564,7
Almond Milk,209,30,45,41,5,3,almond_milk-3,565,4
Almond Milk,922,30,49,44,5,2,almond_milk-4,566,5
Almond Milk,305,28,51,43,4,4,almond_milk-5,567,8
Almond Milk,798,27,47,40,3,1,almond_milk-6,568,7
Almond Milk,628,28,50,40,2,1,almond_milk-7,569,10
Almond Milk,542,30,48,39,2,2,almond_milk-8,570,9
Almond Milk,559,29,48,41,3,1,almond_milk-9,571,7
Almond Milk,523,29,47,32,1,4,almond_milk-10,572,15
Almond Milk,268,28,48,34,1,2,almond_milk-11,573,14
Almond Milk,158,28,50,43,5,3,almond_milk-12,574,7
Almond Milk,51,28,50,44,5,2,almond_milk-13,575,6
Almond Milk,352,28,50,37,2,4,almond_milk-14,576,13
Almond Milk,28,29,49,42,5,4,almond_milk-15,577,7
Almond Milk,768,26,45,32,1,2,almond_milk-16,578,13
Almond Milk,137,30,49,39,2,2,almond_milk-17,579,10
Almond Milk,539,27,51,36,1,1,almond_milk-18,580,15
Almond Milk,213,29,48,41,4,5,almond_milk-19,581,7
Wild-caught Salmon,562,128,249,184,2,2,wildcaught_salmon-0,582,65
Wild-caught Salmon,153,144,254,190,2,3,wildcaught_salmon-1,583,64
Wild-caught Salmon,787,147,252,213,5,5,wildcaught_salmon-2,584,39
Wild-caught Salmon,516,129,236,184,2,1,wildcaught_salmon-3,585,52
Wild-caught Salmon,272,134,240,183,2,2,wildcaught_salmon-4,586,57
Wild-caught Salmon,206,141,234,207,4,2,wildcaught_salmon-5,587,27
Wild-caught Salmon,932,143,252,189,2,3,wildcaught_salmon-6,588,63
Wild-caught Salmon,213,140,258,201,3,4,wildcaught_salmon-7,589,57
Wild-caught Salmon,113,134,243,198,3,2,wildcaught_salmon-8,590,45
Wild-caught Salmon,135,146,254,217,5,4,wildcaught_salmon-9,591,37
Wild-caught Salmon,36,128,256,221,4,1,wildcaught_salmon-10,592,35
Wild-caught Salmon,230,138,234,191,3,3,wildcaught_salmon-11,593,43
Wild-caught Salmon,635,140,252,210,5,5,wildcaught_salmon-12,594,42
Wild-caught Salmon,57,135,243,194,3,3,wildcaught_salmon-13,595,49
Wild-caught Salmon,545,144,243,190,2,2,wildcaught_salmon-14,596,53
Wild-caught Salmon,439,134,240,209,4,2,wildcaught_salmon-15,597,31
Wild-caught Salmon,605,131,243,163,1,2,wildcaught_salmon-16,598,80
Wild-caught Salmon,927,131,249,175,2,4,wildcaught_salmon-17,599,74
Wild-caught Salmon,916,131,245,203,5,5,wildcaught_salmon-18,600,42
Wild-caught Salmon,634,146,234,175,2,5,wildcaught_salmon-19,601,59
Wild-caught Salmon,315,128,249,210,5,3,wildcaught_salmon-20,602,39
Wild-caught Salmon,744,140,236,189,3,4,wildcaught_salmon-21,603,47
Organic Spinach,42,18,30,21,1,3,organic_spinach-0,604,9
Organic Spinach,116,18,31,28,4,1,organic_spinach-1,605,3
Organic Spinach,402,19,32,22,1,4,organic_spinach-2,606,10
Organic Spinach,702,18,31,27,4,3,organic_spinach-3,607,4
Organic Spinach,878,19,33,28,5,5,organic_spinach-4,608,5
Organic Spinach,66,17,31,26,3,2,organic_spinach-5,609,5
Organic Spinach,563,19,30,24,2,4,organic_spinach-6,610,6
Organic Spinach,382,18,31,27,5,4,organic_spinach-7,611,4
Organic Spinach,873,18,33,28,3,1,organic_spinach-8,612,5
Organic Spinach,89,20,32,27,3,4,organic_spinach-9,613,5
Organic Spinach,705,18,30,27,5,3,organic_spinach-10,614,3
Organic Spinach,220,19,31,23,1,2,organic_spinach-11,615,8
Organic Spinach,511,19,32,25,2,2,organic_spinach-12,616,7
Organic Spinach,39,18,32,24,2,4,organic_spinach-13,617,8
Organic Spinach,36,19,33,26,2,2,organic_spinach-14,618,7
Organic Spinach,956,18,33,29,4,3,organic_spinach-15,619,4
Organic Spinach,601,19,31,25,2,2,organic_spinach-16,620,6
Organic Spinach,693,20,30,25,3,5,organic_spinach-17,621,5
Organic Spinach,722,18,33,28,4,4,organic_spinach-18,622,5
Organic Spinach,533,20,30,25,2,3,organic_spinach-19,623,5
Organic Spinach,201,17,33,26,3,4,organic_spinach-20,624,7
Organic Spinach,892,19,34,29,4,5,organic_spinach-21,625,5
Organic Spinach,29,19,30,21,1,5,organic_spinach-22,626,9
Organic Spinach,260,18,32,28,5,2,organic_spinach-23,627,4
Organic Spinach,479,19,33,23,1,3,organic_spinach-24,628,10
Quinoa,77,72,124,99,2,1,quinoa-0,629,25
Quinoa,876,77,123,101,2,1,quinoa-1,630,22
Quinoa,463,78,129,90,1,3,quinoa-2,631,39
Quinoa,802,74,126,103,3,3,quinoa-3,632,23
Quinoa,314,75,138,104,2,2,quinoa-4,633,34
Quinoa,533,74,129,83,1,4,quinoa-5,634,46
Quinoa,74,72,134,113,5,4,quinoa-6,635,21
Quinoa,289,74,136,95,2,5,quinoa-7,636,41
Quinoa,479,68,124,77,1,4,quinoa-8,637,47
Quinoa,458,70,124,102,3,2,quinoa-9,638,22
Quinoa,332,76,123,107,5,4,quinoa-10,639,16
Quinoa,650,79,130,97,1,1,quinoa-11,640,33
Quinoa,186,72,136,103,3,5,quinoa-12,641,33
Quinoa,856,75,126,103,3,3,quinoa-13,642,23
Quinoa,681,72,123,99,3,4,quinoa-14,643,24
Quinoa,814,71,123,105,4,4,quinoa-15,644,18
Quinoa,253,75,128,104,3,3,quinoa-16,645,24
Quinoa,535,74,123,110,5,1,quinoa-17,646,13
Quinoa,172,69,129,100,3,4,quinoa-18,647,29
Quinoa,32,74,135,114,4,4,quinoa-19,648,21
Quinoa,989,70,129,100,2,1,quinoa-20,649,29
Quinoa,793,76,132,95,2,5,quinoa-21,650,37
Quinoa,508,73,129,108,5,5,quinoa-22,651,21
Quinoa,897,73,128,86,1,3,quinoa-23,652,42
Quinoa,695,70,130,112,5,2,quinoa-24,653,18
Quinoa,74,68,135,103,3,4,quinoa-25,654,32
Quinoa,227,72,128,107,4,5,quinoa-26,655,21
Quinoa,187,73,122,107,5,3,quinoa-27,656,15
Greek Yogurt,956,56,94,69,1,1,greek_yogurt-0,657,25
Greek Yogurt,501,52,90,65,1,1,greek_yogurt-1,658,25
Greek Yogurt,21,53,92,68,2,4,greek_yogurt-2,659,24
Greek Yogurt,291,51,92,65,2,5,greek_yogurt-3,660,27
Greek Yogurt,346,54,97,81,3,1,greek_yogurt-4,661,16
Greek Yogurt,488,57,100,62,1,5,greek_yogurt-5,662,38
Greek Yogurt,26,57,95,81,3,1,greek_yogurt-6,663,14
Greek Yogurt,186,54,99,77,3,4,greek_yogurt-7,664,22
Greek Yogurt,533,59,95,77,3,5,greek_yogurt-8,665,18
Greek Yogurt,864,59,92,77,3,3,greek_yogurt-9,666,15
Greek Yogurt,891,57,91,81,5,2,greek_yogurt-10,667,10
Greek Yogurt,842,54,101,70,2,5,greek_yogurt-11,668,31
Greek Yogurt,33,56,92,79,4,5,greek_yogurt-12,669,13
Greek Yogurt,168,58,98,79,2,1,greek_yogurt-13,670,19
Greek Yogurt,597,52,99,82,5,5,greek_yogurt-14,671,17
Greek Yogurt,486,60,92,66,1,4,greek_yogurt-15,672,26
Greek Yogurt,482,59,102,87,4,4,greek_yogurt-16,673,15
Greek Yogurt,633,60,96,78,3,5,greek_yogurt-17,674,18
Greek Yogurt,119,53,93,75,3,3,greek_yogurt-18,675,18
Greek Yogurt,600,53,99,64,1,3,greek_yogurt-19,676,35
Greek Yogurt,366,54,98,82,4,5,greek_yogurt-20,677,16
Organic Apples,978,72,127,110,4,3,organic_apples-0,678,17
Organic Apples,653,69,138,120,5,1,organic_apples-1,679,18
Organic Apples,999,79,133,115,5,4,organic_apples-2,680,18
Organic Apples,621,76,126,102,3,4,organic_apples-3,681,24
Organic Apples,634,75,135,103,2,2,organic_apples-4,682,32
Organic Apples,982,68,122,84,1,2,organic_apples-5,683,38
Organic Apples,686,80,135,118,4,3,organic_apples-6,684,17
Organic Apples,146,68,123,100,3,2,organic_apples-7,685,23
Organic Apples,163,78,135,114,3,1,organic_apples-8,686,21
Organic Apples,501,76,121,105,5,5,organic_apples-9,687,16
Organic Apples,132,68,128,106,4,5,organic_apples-10,688,22
Organic Apples,548,70,127,110,5,2,organic_apples-11,689,17
Organic Apples,944,69,134,109,3,1,organic_apples-12,690,25
Organic Apples,70,70,133,113,4,3,organic_apples-13,691,20
Organic Apples,826,74,128,108,3,1,organic_apples-14,692,20
Organic Apples,785,71,129,111,5,3,organic_apples-15,693,18
Organic Apples,842,80,122,100,2,2,organic_apples-16,694,22
Organic Apples,341,76,127,111,5,3,organic_apples-17,695,16
Organic Apples,168,77,122,104,3,2,organic_apples-18,696,18
Organic Apples,974,76,123,107,4,4,organic_apples-19,697,16
Organic Apples,696,80,122,108,5,4,organic_apples-20,698,14
Organic Apples,177,71,129,112,4,2,organic_apples-21,699,17
Extra Virgin Olive Oil,783,43,78,51,1,3,extra_virgin_olive_oil-0,700,27
Extra Virgin Olive Oil,668,49,78,69,4,3,extra_virgin_olive_oil-1,701,9
Extra Virgin Olive Oil,498,47,85,72,5,4,extra_virgin_olive_oil-2,702,13
Extra Virgin Olive Oil,210,47,85,67,3,4,extra_virgin_olive_oil-3,703,18
Extra Virgin Olive Oil,285,47,80,68,4,5,extra_virgin_olive_oil-4,704,12
Extra Virgin Olive Oil,985,45,79,70,5,1,extra_virgin_olive_oil-5,705,9
Extra Virgin Olive Oil,186,50,85,62,1,1,extra_virgin_olive_oil-6,706,23
Extra Virgin Olive Oil,749,50,77,69,4,3,extra_virgin_olive_oil-7,707,8
Extra Virgin Olive Oil,424,48,83,69,3,2,extra_virgin_olive_oil-8,708,14
Extra Virgin Olive Oil,834,49,79,71,4,1,extra_virgin_olive_oil-9,709,8
Extra Virgin Olive Oil,412,46,86,70,3,2,extra_virgin_olive_oil-10,710,16
Extra Virgin Olive Oil,359,43,78,68,4,2,extra_virgin_olive_oil-11,711,10
Extra Virgin Olive Oil,732,46,84,73,5,2,extra_virgin_olive_oil-12,712,11
Extra Virgin Olive Oil,900,44,85,67,3,3,extra_virgin_olive_oil-13,713,18
Extra Virgin Olive Oil,630,44,76,62,3,3,extra_virgin_olive_oil-14,714,14
Extra Virgin Olive Oil,81,48,81,62,2,3,extra_virgin_olive_oil-15,715,19
Extra Virgin Olive Oil,963,45,81,62,2,2,extra_virgin_olive_oil-16,716,19
Extra Virgin Olive Oil,199,44,75,60,3,4,extra_virgin_olive_oil-17,717,15
Extra Virgin Olive Oil,876,50,78,65,2,1,extra_virgin_olive_oil-18,718,13
Extra Virgin Olive Oil,679,46,76,67,4,2,extra_virgin_olive_oil-19,719,9
Extra Virgin Olive Oil,497,48,86,72,3,1,extra_virgin_olive_oil-20,720,14
Brown Rice,133,59,94,76,2,2,brown_rice-0,721,18
Brown Rice,480,59,103,82,2,1,brown_rice-1,722,21
Brown Rice,503,57,92,78,3,2,brown_rice-2,723,14
Brown Rice,791,53,93,74,3,4,brown_rice-3,724,19
Brown Rice,353,53,90,62,1,3,brown_rice-4,725,28
Brown Rice,948,58,99,70,1,2,brown_rice-5,726,29
Brown Rice,428,57,98,87,5,1,brown_rice-6,727,11
Brown Rice,407,53,91,73,2,1,brown_rice-7,728,18
Brown Rice,216,52,99,75,3,5,brown_rice-8,729,24
Brown Rice,367,54,97,74,2,2,brown_rice-9,730,23
Brown Rice,970,59,103,90,4,2,brown_rice-10,731,13
Brown Rice,891,56,93,62,1,4,brown_rice-11,732,31
Brown Rice,39,54,92,79,5,4,brown_rice-12,733,13
Brown Rice,533,54,103,62,1,4,brown_rice-13,734,41
Brown Rice,67,59,100,78,2,2,brown_rice-14,735,22
Brown Rice,593,60,96,85,4,3,brown_rice-15,736,11
Brown Rice,100,54,98,86,5,1,brown_rice-16,737,12
Brown Rice,899,60,95,81,3,2,brown_rice-17,738,14
Brown Rice,491,57,95,72,2,4,brown_rice-18,739,23
Brown Rice,774,57,101,72,1,1,brown_rice-19,740,29
Brown Rice,352,51,101,65,1,2,brown_rice-20,741,36
Brown Rice,795,54,96,69,1,1,brown_rice-21,742,27
Brown Rice,966,56,90,73,3,5,brown_rice-22,743,17
Brown Rice,806,51,92,80,4,2,brown_rice-23,744,12
Brown Rice,436,52,94,67,1,1,brown_rice-24,745,27
Organic Chicken Breast,286,119,207,171,3,2,organic_chicken_breast-0,746,36
Organic Chicken Breast,474,118,192,167,4,4,organic_chicken_breast-1,747,25
Organic Chicken Breast,108,104,185,159,4,3,organic_chicken_breast-2,748,26
Organic Chicken Breast,84,111,207,176,5,3,organic_chicken_breast-3,749,31
Organic Chicken Breast,163,118,199,141,1,2,organic_chicken_breast-4,750,58
Organic Chicken Breast,63,107,192,121,1,4,organic_chicken_breast-5,751,71
Organic Chicken Breast,886,113,187,148,2,2,organic_chicken_breast-6,752,39
Organic Chicken Breast,644,111,183,158,5,4,organic_chicken_breast-7,753,25
Organic Chicken Breast,423,104,185,145,2,1,organic_chicken_breast-8,754,40
Organic Chicken Breast,421,112,192,146,2,3,organic_chicken_breast-9,755,46
Organic Chicken Breast,465,111,187,156,3,2,organic_chicken_breast-10,756,31
Organic Chicken Breast,363,108,181,142,2,2,organic_chicken_breast-11,757,39
Organic Chicken Breast,165,111,205,173,4,4,organic_chicken_breast-12,758,32
Organic Chicken Breast,271,108,194,169,4,2,organic_chicken_breast-13,759,25
Organic Chicken Breast,287,104,201,120,1,4,organic_chicken_breast-14,760,81
Organic Chicken Breast,782,102,201,152,2,1,organic_chicken_breast-15,761,49
Organic Chicken Breast,938,105,203,155,3,4,organic_chicken_breast-16,762,48
Organic Chicken Breast,756,119,190,166,5,4,organic_chicken_breast-17,763,24
Organic Chicken Breast,967,102,194,165,4,3,organic_chicken_breast-18,764,29
Organic Chicken Breast,33,114,185,164,5,2,organic_chicken_breast-19,765,21
Organic Chicken Breast,60,108,201,143,2,4,organic_chicken_breast-20,766,58
Raw Honey,205,73,134,83,1,4,raw_honey-0,767,51
Raw Honey,26,72,124,96,2,2,raw_honey-1,768,28
Raw Honey,643,79,124,102,2,1,raw_honey-2,769,22
Raw Honey,757,78,135,106,3,5,raw_honey-3,770,29
Raw Honey,399,74,136,113,5,5,raw_honey-4,771,23
Raw Honey,716,78,128,101,2,2,raw_honey-5,772,27
Raw Honey,871,76,134,106,2,1,raw_honey-6,773,28
Raw Honey,211,72,128,78,1,5,raw_honey-7,774,50
Raw Honey,707,71,136,112,4,5,raw_honey-8,775,24
Raw Honey,563,79,124,112,5,1,raw_honey-9,776,12
Raw Honey,714,71,128,110,5,3,raw_honey-10,777,18
Raw Honey,167,70,127,109,4,3,raw_honey-11,778,18
Raw Honey,30,72,126,98,3,5,raw_honey-12,779,28
Raw Honey,809,77,122,106,4,5,raw_honey-13,780,16
Raw Honey,146,72,134,111,3,1,raw_honey-14,781,23
Raw Honey,304,76,136,118,5,2,raw_honey-15,782,18
Raw Honey,504,75,133,118,4,1,raw_honey-16,783,15
Raw Honey,90,68,127,107,5,4,raw_honey-17,784,20
Raw Honey,335,73,132,110,3,1,raw_honey-18,785,22
Raw Honey,156,80,121,108,4,3,raw_honey-19,786,13
Raw Honey,655,68,126,102,3,2,raw_honey-20,787,24
Raw Honey,666,72,138,114,5,5,raw_honey-21,788,24
Raw Honey,249,69,129,100,3,4,raw_honey-22,789,29
Raw Honey,726,72,133,110,3,1,raw_honey-23,790,23
Raw Honey,869,73,123,107,4,3,raw_honey-24,791,16
Mixed Berries,419,43,78,56,2,4,mixed_berries-0,792,22
Mixed Berries,422,43,81,64,3,3,mixed_berries-1,793,17
Mixed Berries,531,47,78,70,4,1,mixed_berries-2,794,8
Mixed Berries,922,45,81,69,4,4,mixed_berries-3,795,12
Mixed Berries,821,49,85,60,1,2,mixed_berries-4,796,25
Mixed Berries,499,48,84,56,1,3,mixed_berries-5,797,28
Mixed Berries,735,45,84,72,4,3,mixed_berries-6,798,12
Mixed Berries,53,43,78,65,5,5,mixed_berries-7,799,13
Mixed Berries,532,46,76,67,5,2,mixed_berries-8,800,9
Mixed Berries,966,43,81,70,4,2,mixed_berries-9,801,11
Mixed Berries,748,48,76,67,4,3,mixed_berries-10,802,9
Mixed Berries,671,45,83,72,5,2,mixed_berries-11,803,11
Mixed Berries,772,44,80,67,5,5,mixed_berries-12,804,13
Mixed Berries,765,48,82,64,2,2,mixed_berries-13,805,18
Mixed Berries,738,45,76,56,1,1,mixed_berries-14,806,20
Mixed Berries,764,48,86,67,3,5,mixed_berries-15,807,19
Mixed Berries,719,46,76,58,2,4,mixed_berries-16,808,18
Mixed Berries,554,43,84,59,2,4,mixed_berries-17,809,25
Mixed Berries,694,45,77,57,2,4,mixed_berries-18,810,20
Mixed Berries,801,45,83,66,3,3,mixed_berries-19,811,17
Mixed Berries,429,43,86,71,4,4,mixed_berries-20,812,15
Mixed Berries,533,44,78,69,4,1,mixed_berries-21,813,9
Chia Seeds,775,64,111,75,1,3,chia_seeds-0,814,36
Chia Seeds,802,67,113,91,2,1,chia_seeds-1,815,22
Chia Seeds,821,64,117,91,2,1,chia_seeds-2,816,26
Chia Seeds,588,67,111,96,4,4,chia_seeds-3,817,15
Chia Seeds,76,61,118,95,3,2,chia_seeds-4,818,23
Chia Seeds,202,65,110,96,5,3,chia_seeds-5,819,14
Chia Seeds,674,67,109,81,2,5,chia_seeds-6,820,28
Chia Seeds,203,70,112,75,1,5,chia_seeds-7,821,37
Chia Seeds,664,67,106,91,3,1,chia_seeds-8,822,15
Chia Seeds,342,62,106,93,4,2,chia_seeds-9,823,13
Chia Seeds,495,68,108,90,3,3,chia_seeds-10,824,18
Chia Seeds,505,66,114,101,5,1,chia_seeds-11,825,13
Chia Seeds,287,70,109,74,1,5,chia_seeds-12,826,35
Chia Seeds,172,65,114,89,3,5,chia_seeds-13,827,25
Chia Seeds,511,66,108,91,3,2,chia_seeds-14,828,17
Chia Seeds,462,61,112,80,2,4,chia_seeds-15,829,32
Chia Seeds,53,64,112,72,1,4,chia_seeds-16,830,40
Chia Seeds,581,68,107,96,4,2,chia_seeds-17,831,11
Chia Seeds,736,69,118,93,3,5,chia_seeds-18,832,25
Chia Seeds,58,67,106,74,1,4,chia_seeds-19,833,32
Grass-fed Beef,604,192,324,241,2,4,grassfed_beef-0,834,83
Grass-fed Beef,915,196,324,275,3,1,grassfed_beef-1,835,49
Grass-fed Beef,832,188,321,226,1,2,grassfed_beef-2,836,95
Grass-fed Beef,607,194,342,287,4,5,grassfed_beef-3,837,55
Grass-fed Beef,484,196,309,235,1,1,grassfed_beef-4,838,74
Grass-fed Beef,414,170,345,230,1,1,grassfed_beef-5,839,115
Grass-fed Beef,590,194,321,274,4,5,grassfed_beef-6,840,47
Grass-fed Beef,641,172,336,248,2,2,grassfed_beef-7,841,88
Grass-fed Beef,157,182,330,279,4,4,grassfed_beef-8,842,51
Grass-fed Beef,312,192,306,264,4,5,grassfed_beef-9,843,42
Grass-fed Beef,511,192,333,264,3,4,grassfed_beef-10,844,69
Grass-fed Beef,427,182,342,237,1,1,grassfed_beef-11,845,105
Grass-fed Beef,183,184,303,204,1,4,grassfed_beef-12,846,99
Grass-fed Beef,199,196,330,280,5,5,grassfed_beef-13,847,50
Grass-fed Beef,147,182,336,261,3,4,grassfed_beef-14,848,75
Grass-fed Beef,210,188,309,228,2,5,grassfed_beef-15,849,81
Grass-fed Beef,423,174,324,198,1,4,grassfed_beef-16,850,126
Grass-fed Beef,186,196,303,247,3,5,grassfed_beef-17,851,56
Grass-fed Beef,469,184,321,274,4,4,grassfed_beef-18,852,47
Grass-fed Beef,657,194,336,241,2,5,grassfed_beef-19,853,95
Grass-fed Beef,863,180,327,280,5,3,grassfed_beef-20,854,47
Grass-fed Beef,171,180,315,275,4,2,grassfed_beef-21,855,40
Grass-fed Beef,910,180,312,210,1,3,grassfed_beef-22,856,102
Grass-fed Beef,595,192,330,279,4,5,grassfed_beef-23,857,51
Grass-fed Beef,160,182,330,231,2,5,grassfed_beef-24,858,99
Grass-fed Beef,411,196,309,215,1,4,grassfed_beef-25,859,94
Grass-fed Beef,513,182,333,207,1,4,grassfed_beef-26,860,126
Grass-fed Beef,60,182,342,270,3,3,grassfed_beef-27,861,72
Gluten-free Pasta,342,73,124,82,1,4,glutenfree_pasta-0,862,42
Gluten-free Pasta,991,79,127,109,3,1,glutenfree_pasta-1,863,18
Gluten-free Pasta,511,77,135,94,1,2,glutenfree_pasta-2,864,41
Gluten-free Pasta,142,72,133,111,5,5,glutenfree_pasta-3,865,22
Gluten-free Pasta,738,76,123,84,1,4,glutenfree_pasta-4,866,39
Gluten-free Pasta,971,80,124,110,4,3,glutenfree_pasta-5,867,14
Gluten-free Pasta,457,71,122,97,2,1,glutenfree_pasta-6,868,25
Gluten-free Pasta,358,72,136,117,4,2,glutenfree_pasta-7,869,19
Gluten-free Pasta,969,76,129,91,1,2,glutenfree_pasta-8,870,38
Gluten-free Pasta,389,75,135,95,2,5,glutenfree_pasta-9,871,40
Gluten-free Pasta,398,80,128,85,1,5,glutenfree_pasta-10,872,43
Gluten-free Pasta,304,74,138,114,4,5,glutenfree_pasta-11,873,24
Gluten-free Pasta,37,71,121,82,1,3,glutenfree_pasta-12,874,39
Gluten-free Pasta,621,78,138,116,4,5,glutenfree_pasta-13,875,22
Gluten-free Pasta,293,75,132,113,4,4,glutenfree_pasta-14,876,19
Gluten-free Pasta,540,80,126,98,2,4,glutenfree_pasta-15,877,28
Gluten-free Pasta,72,76,121,86,1,3,glutenfree_pasta-16,878,35
Gluten-free Pasta,534,80,128,115,5,1,glutenfree_pasta-17,879,13
Gluten-free Pasta,165,73,136,118,4,2,glutenfree_pasta-18,880,18
Gluten-free Pasta,623,70,128,83,1,3,glutenfree_pasta-19,881,45
Organic Kale,813,27,51,44,5,2,organic_kale-0,882,7
Organic Kale,566,27,47,37,3,5,organic_kale-1,883,10
Organic Kale,693,28,49,37,2,3,organic_kale-2,884,12
Organic Kale,560,30,46,39,3,3,organic_kale-3,885,7
Organic Kale,438,27,47,38,3,3,organic_kale-4,886,9
Organic Kale,588,28,49,43,5,3,organic_kale-5,887,6
Organic Kale,540,29,46,33,1,3,organic_kale-6,888,13
Organic Kale,434,30,51,44,5,5,organic_kale-7,889,7
Organic Kale,453,30,49,42,3,1,organic_kale-8,890,7
Organic Kale,359,27,45,41,5,1,organic_kale-9,891,4
Organic Kale,728,30,47,43,4,1,organic_kale-10,892,4
Organic Kale,760,28,48,41,5,5,organic_kale-11,893,7
Organic Kale,814,30,49,37,2,5,organic_kale-12,894,12
Organic Kale,460,29,48,41,5,5,organic_kale-13,895,7
Organic Kale,721,27,46,38,3,3,organic_kale-14,896,8
Organic Kale,918,27,48,40,3,2,organic_kale-15,897,8
Organic Kale,958,29,46,38,3,4,organic_kale-16,898,8
Organic Kale,809,29,50,45,5,1,organic_kale-17,899,5
Organic Kale,799,29,45,41,5,2,organic_kale-18,900,4
Organic Kale,637,30,51,35,1,3,organic_kale-19,901,16
Coconut Water,956,38,66,48,1,1,coconut_water-0,902,18
Coconut Water,319,39,64,42,1,5,coconut_water-1,903,22
Coconut Water,713,36,66,45,1,2,coconut_water-2,904,21
Coconut Water,665,36,63,56,4,1,coconut_water-3,905,7
Coconut Water,993,38,64,47,2,5,coconut_water-4,906,17
Coconut Water,308,35,67,52,3,4,coconut_water-5,907,15
Coconut Water,879,34,63,54,4,3,coconut_water-6,908,9
Coconut Water,293,38,68,50,2,4,coconut_water-7,909,18
Coconut Water,388,35,67,54,3,2,coconut_water-8,910,13
Coconut Water,101,36,64,51,2,1,coconut_water-9,911,13
Coconut Water,81,35,68,59,5,2,coconut_water-10,912,9
Coconut Water,269,38,67,53,2,1,coconut_water-11,913,14
Coconut Water,509,38,66,50,2,3,coconut_water-12,914,16
Coconut Water,646,38,64,57,4,1,coconut_water-13,915,7
Coconut Water,939,38,64,56,4,3,coconut_water-14,916,8
Coconut Water,240,36,64,54,5,5,coconut_water-15,917,10
Coconut Water,420,35,62,54,4,2,coconut_water-16,918,8
Coconut Water,713,35,68,59,5,1,coconut_water-17,919,9
Coconut Water,200,38,67,58,5,3,coconut_water-18,920,9
Coconut Water,508,34,65,45,1,1,coconut_water-19,921,20
Coconut Water,924,37,68,46,1,2,coconut_water-20,922,22
Coconut Water,589,37,64,51,3,4,coconut_water-21,923,13
Coconut Water,854,35,61,43,1,2,coconut_water-22,924,18
Coconut Water,472,36,62,55,5,2,coconut_water-23,925,7
Organic Black Beans,258,43,85,59,2,4,organic_black_beans-0,926,26
Organic Black Beans,593,46,83,65,2,1,organic_black_beans-1,927,18
Organic Black Beans,192,49,84,61,1,1,organic_black_beans-2,928,23
Organic Black Beans,78,43,81,47,1,5,organic_black_beans-3,929,34
Organic Black Beans,141,43,81,66,3,2,organic_black_beans-4,930,15
Organic Black Beans,392,45,81,69,4,4,organic_black_beans-5,931,12
Organic Black Beans,928,43,83,47,1,5,organic_black_beans-6,932,36
Organic Black Beans,702,46,84,72,5,3,organic_black_beans-7,933,12
Organic Black Beans,62,49,80,66,3,3,organic_black_beans-8,934,14
Organic Black Beans,817,48,84,67,3,4,organic_black_beans-9,935,17
Organic Black Beans,379,48,77,59,2,4,organic_black_beans-10,936,18
Organic Black Beans,279,48,80,64,3,5,organic_black_beans-11,937,16
Organic Black Beans,663,43,78,60,3,5,organic_black_beans-12,938,18
Organic Black Beans,532,44,86,58,2,5,organic_black_beans-13,939,28
Organic Black Beans,859,47,78,68,5,4,organic_black_beans-14,940,10
Organic Black Beans,870,44,81,57,2,5,organic_black_beans-15,941,24
Organic Black Beans,578,45,79,49,1,5,organic_black_beans-16,942,30
Organic Black Beans,341,43,81,68,5,4,organic_black_beans-17,943,13
Organic Black Beans,556,43,84,72,5,2,organic_black_beans-18,944,12
Organic Black Beans,490,46,84,72,4,3,organic_black_beans-19,945,12
Organic Black Beans,374,44,84,63,3,5,organic_black_beans-20,946,21
Organic Black Beans,420,46,81,70,4,3,organic_black_beans-21,947,11
Organic Black Beans,264,44,78,68,4,2,organic_black_beans-22,948,10
Organic Black Beans,686,43,78,65,5,5,organic_black_beans-23,949,13
Organic Black Beans,397,43,78,61,2,1,organic_black_beans-24,950,17
Organic Black Beans,34,46,80,70,4,2,organic_black_beans-25,951,10
Organic Black Beans,168,45,84,71,5,4,organic_black_beans-26,952,13
Google Nest Thermostat,134,5760,10080,8115,3,3,google_nest_thermostat-0,953,1965
Google Nest Thermostat,541,5100,10170,8649,4,2,google_nest_thermostat-1,954,1521
Google Nest Thermostat,379,5760,10170,8737,5,3,google_nest_thermostat-2,955,1433
Google Nest Thermostat,935,5940,10080,8528,4,5,google_nest_thermostat-3,956,1552
Google Nest Thermostat,952,5760,10350,8629,5,5,google_nest_thermostat-4,957,1721
Google Nest Thermostat,533,5580,9810,7526,2,2,google_nest_thermostat-5,958,2284
Google Nest Thermostat,133,5760,9540,8085,3,1,google_nest_thermostat-6,959,1455
Google Nest Thermostat,869,5640,9810,7559,2,2,google_nest_thermostat-7,960,2251
Google Nest Thermostat,205,5400,9540,8195,5,3,google_nest_thermostat-8,961,1345
Google Nest Thermostat,330,5460,9090,6804,2,4,google_nest_thermostat-9,962,2286
Google Nest Thermostat,795,5160,10260,8603,5,3,google_nest_thermostat-10,963,1657
Google Nest Thermostat,147,5400,10170,8000,3,3,google_nest_thermostat-11,964,2170
Google Nest Thermostat,980,5820,9990,7176,2,5,google_nest_thermostat-12,965,2814
Google Nest Thermostat,610,5100,9270,7707,5,5,google_nest_thermostat-13,966,1563
Google Nest Thermostat,595,5460,9450,7116,2,3,google_nest_thermostat-14,967,2334
Google Nest Thermostat,129,5100,9450,6514,2,5,google_nest_thermostat-15,968,2936
Google Nest Thermostat,524,5820,10170,6255,1,5,google_nest_thermostat-16,969,3915
Google Nest Thermostat,73,5340,9900,8418,4,3,google_nest_thermostat-17,970,1482
Google Nest Thermostat,135,5760,9450,7126,2,4,google_nest_thermostat-18,971,2324
Google Nest Thermostat,492,5400,9990,8223,3,1,google_nest_thermostat-19,972,1767
Ring Video Doorbell,68,7840,13560,8756,1,4,ring_video_doorbell-0,973,4804
Ring Video Doorbell,273,7760,12840,11189,4,3,ring_video_doorbell-1,974,1651
Ring Video Doorbell,447,7360,12120,9955,3,3,ring_video_doorbell-2,975,2165
Ring Video Doorbell,643,7440,13080,11388,5,2,ring_video_doorbell-3,976,1692
Ring Video Doorbell,962,6800,13560,9910,2,2,ring_video_doorbell-4,977,3650
Ring Video Doorbell,423,7520,13440,10747,3,3,ring_video_doorbell-5,978,2693
Ring Video Doorbell,220,7520,12120,10395,5,5,ring_video_doorbell-6,979,1725
Ring Video Doorbell,714,7680,13080,11460,4,2,ring_video_doorbell-7,980,1620
Ring Video Doorbell,923,7120,13440,10028,2,2,ring_video_doorbell-8,981,3412
Ring Video Doorbell,466,7680,13560,11649,4,3,ring_video_doorbell-9,982,1911
Ring Video Doorbell,605,6800,12720,10027,3,3,ring_video_doorbell-10,983,2693
Ring Video Doorbell,919,7760,13800,10629,3,5,ring_video_doorbell-11,984,3171
Ring Video Doorbell,362,7120,12480,10470,5,5,ring_video_doorbell-12,985,2010
Ring Video Doorbell,796,6800,12240,10744,5,1,ring_video_doorbell-13,986,1496
Ring Video Doorbell,721,7040,12840,11100,5,2,ring_video_doorbell-14,987,1740
Ring Video Doorbell,931,7120,12960,9281,2,4,ring_video_doorbell-15,988,3679
Ring Video Doorbell,784,7520,13680,11986,5,1,ring_video_doorbell-16,989,1694
Ring Video Doorbell,313,7280,13440,10853,3,2,ring_video_doorbell-17,990,2587
Ring Video Doorbell,244,7600,12240,9317,2,4,ring_video_doorbell-18,991,2923
Ring Video Doorbell,525,7840,13200,11726,4,1,ring_video_doorbell-19,992,1474
Ring Video Doorbell,672,7600,12600,10850,5,4,ring_video_doorbell-20,993,1750
Ring Video Doorbell,261,6800,12840,8492,1,2,ring_video_doorbell-21,994,4348
Ring Video Doorbell,515,7520,13800,12073,5,1,ring_video_doorbell-22,995,1727
Ring Video Doorbell,1000,7920,12840,10184,2,2,ring_video_doorbell-23,996,2656
Ring Video Doorbell,998,7760,13680,11401,3,1,ring_video_doorbell-24,997,2279
Ring Video Doorbell,656,7440,13080,8004,1,5,ring_video_doorbell-25,998,5076
Ring Video Doorbell,734,7360,13560,9375,2,5,ring_video_doorbell-26,999,4185
Philips Hue Smart Bulbs,283,3520,6600,4937,2,2,philips_hue_smart_bulbs-0,1000,1663
Philips Hue Smart Bulbs,522,3960,6420,5092,2,2,philips_hue_smart_bulbs-1,1001,1328
Philips Hue Smart Bulbs,33,3520,6360,4316,1,2,philips_hue_smart_bulbs-2,1002,2044
Philips Hue Smart Bulbs,613,3560,6300,5547,5,1,philips_hue_smart_bulbs-3,1003,753
Philips Hue Smart Bulbs,474,3800,6840,4925,2,4,philips_hue_smart_bulbs-4,1004,1915
Philips Hue Smart Bulbs,110,3600,6060,3846,1,5,philips_hue_smart_bulbs-5,1005,2214
Philips Hue Smart Bulbs,562,3640,6840,5608,3,1,philips_hue_smart_bulbs-6,1006,1232
Philips Hue Smart Bulbs,857,3560,6540,5065,2,1,philips_hue_smart_bulbs-7,1007,1475
Philips Hue Smart Bulbs,179,3920,6540,5244,2,1,philips_hue_smart_bulbs-8,1008,1296
Philips Hue Smart Bulbs,471,3880,6660,5618,4,5,philips_hue_smart_bulbs-9,1009,1042
Philips Hue Smart Bulbs,834,3800,6240,4959,3,5,philips_hue_smart_bulbs-10,1010,1281
Philips Hue Smart Bulbs,987,3920,6600,4791,2,5,philips_hue_smart_bulbs-11,1011,1809
Philips Hue Smart Bulbs,508,3400,6480,4263,1,2,philips_hue_smart_bulbs-12,1012,2217
Philips Hue Smart Bulbs,936,3520,6480,5444,5,4,philips_hue_smart_bulbs-13,1013,1036
Philips Hue Smart Bulbs,937,3520,6480,4527,1,1,philips_hue_smart_bulbs-14,1014,1953
Philips Hue Smart Bulbs,49,3480,6060,4048,1,3,philips_hue_smart_bulbs-15,1015,2012
Philips Hue Smart Bulbs,849,3400,6540,5677,5,1,philips_hue_smart_bulbs-16,1016,863
Philips Hue Smart Bulbs,315,3680,6480,4632,1,1,philips_hue_smart_bulbs-17,1017,1848
Philips Hue Smart Bulbs,695,3400,6900,5588,4,5,philips_hue_smart_bulbs-18,1018,1312
Philips Hue Smart Bulbs,599,3480,6120,5262,5,3,philips_hue_smart_bulbs-19,1019,858
Philips Hue Smart Bulbs,666,3720,6780,4761,1,1,philips_hue_smart_bulbs-20,1020,2019
Philips Hue Smart Bulbs,642,3560,6300,5246,3,1,philips_hue_smart_bulbs-21,1021,1054
Philips Hue Smart Bulbs,354,3440,6480,5492,5,3,philips_hue_smart_bulbs-22,1022,988
Amazon Echo Dot (4th Gen),379,2760,4950,3111,1,4,amazon_echo_dot_4th_gen-0,1023,1839
Amazon Echo Dot (4th Gen),282,2550,4860,3197,1,2,amazon_echo_dot_4th_gen-1,1024,1663
Amazon Echo Dot (4th Gen),509,2670,5085,3781,2,2,amazon_echo_dot_4th_gen-2,1025,1304
Amazon Echo Dot (4th Gen),181,2610,4770,3712,3,4,amazon_echo_dot_4th_gen-3,1026,1058
Amazon Echo Dot (4th Gen),760,2790,5130,4487,4,1,amazon_echo_dot_4th_gen-4,1027,643
Amazon Echo Dot (4th Gen),416,2670,4815,4065,4,4,amazon_echo_dot_4th_gen-5,1028,750
Amazon Echo Dot (4th Gen),786,2820,4770,3132,1,4,amazon_echo_dot_4th_gen-6,1029,1638
Amazon Echo Dot (4th Gen),728,2940,4725,4038,3,1,amazon_echo_dot_4th_gen-7,1030,687
Amazon Echo Dot (4th Gen),402,2730,5130,3258,1,3,amazon_echo_dot_4th_gen-8,1031,1872
Amazon Echo Dot (4th Gen),768,2580,4905,3766,3,4,amazon_echo_dot_4th_gen-9,1032,1139
Amazon Echo Dot (4th Gen),526,2670,4860,3415,1,1,amazon_echo_dot_4th_gen-10,1033,1445
Amazon Echo Dot (4th Gen),59,2880,4725,4015,3,1,amazon_echo_dot_4th_gen-11,1034,710
Amazon Echo Dot (4th Gen),274,2700,4905,4057,3,1,amazon_echo_dot_4th_gen-12,1035,848
Amazon Echo Dot (4th Gen),837,2550,4545,3229,1,1,amazon_echo_dot_4th_gen-13,1036,1316
Amazon Echo Dot (4th Gen),144,2970,4635,3820,3,4,amazon_echo_dot_4th_gen-14,1037,815
Amazon Echo Dot (4th Gen),994,2730,4815,3783,2,1,amazon_echo_dot_4th_gen-15,1038,1032
Amazon Echo Dot (4th Gen),75,2940,4770,3343,1,3,amazon_echo_dot_4th_gen-16,1039,1427
Amazon Echo Dot (4th Gen),965,2640,4950,4142,4,4,amazon_echo_dot_4th_gen-17,1040,808
Amazon Echo Dot (4th Gen),658,2550,5175,3889,3,4,amazon_echo_dot_4th_gen-18,1041,1286
Amazon Echo Dot (4th Gen),912,2670,4725,4109,5,2,amazon_echo_dot_4th_gen-19,1042,616
Nest Hello Video Doorbell,70,9900,16800,14213,4,5,nest_hello_video_doorbell-0,1043,2587
Nest Hello Video Doorbell,48,9100,17100,14700,4,2,nest_hello_video_doorbell-1,1044,2400
Nest Hello Video Doorbell,246,8700,15600,12185,2,1,nest_hello_video_doorbell-2,1045,3415
Nest Hello Video Doorbell,214,9200,16350,10344,1,4,nest_hello_video_doorbell-3,1046,6006
Nest Hello Video Doorbell,395,9200,15300,12311,3,4,nest_hello_video_doorbell-4,1047,2989
Nest Hello Video Doorbell,342,8700,16500,13497,3,1,nest_hello_video_doorbell-5,1048,3003
Nest Hello Video Doorbell,130,8500,16500,13500,5,5,nest_hello_video_doorbell-6,1049,3000
Nest Hello Video Doorbell,331,8900,15450,13322,5,3,nest_hello_video_doorbell-7,1050,2128
Nest Hello Video Doorbell,892,9600,16950,12981,2,2,nest_hello_video_doorbell-8,1051,3969
Nest Hello Video Doorbell,79,9200,15600,11280,2,5,nest_hello_video_doorbell-9,1052,4320
Nest Hello Video Doorbell,486,9100,16500,13651,3,1,nest_hello_video_doorbell-10,1053,2849
Nest Hello Video Doorbell,982,9900,15600,13890,5,2,nest_hello_video_doorbell-11,1054,1710
Nest Hello Video Doorbell,39,9100,16800,14683,5,1,nest_hello_video_doorbell-12,1055,2117
Nest Hello Video Doorbell,799,8600,15600,12170,3,4,nest_hello_video_doorbell-13,1056,3430
Nest Hello Video Doorbell,487,9300,15900,13755,4,3,nest_hello_video_doorbell-14,1057,2145
Nest Hello Video Doorbell,50,9200,16800,9960,1,5,nest_hello_video_doorbell-15,1058,6840
Nest Hello Video Doorbell,447,9400,15300,13678,5,1,nest_hello_video_doorbell-16,1059,1622
Nest Hello Video Doorbell,375,9100,16050,11359,2,5,nest_hello_video_doorbell-17,1060,4691
Nest Hello Video Doorbell,132,8700,15300,10548,1,2,nest_hello_video_doorbell-18,1061,4752
Nest Hello Video Doorbell,133,9600,16500,13602,3,2,nest_hello_video_doorbell-19,1062,2898
Nest Hello Video Doorbell,692,8900,16050,12797,3,3,nest_hello_video_doorbell-20,1063,3253
Nest Hello Video Doorbell,677,8500,16350,13995,5,2,nest_hello_video_doorbell-21,1064,2355
Nest Hello Video Doorbell,448,8800,15450,11859,2,2,nest_hello_video_doorbell-22,1065,3591
Ecobee Smart Thermostat,404,5950,10815,8261,3,5,ecobee_smart_thermostat-0,1066,2554
Ecobee Smart Thermostat,810,6650,11865,10040,5,4,ecobee_smart_thermostat-1,1067,1825
Ecobee Smart Thermostat,578,6300,11550,10107,4,1,ecobee_smart_thermostat-2,1068,1443
Ecobee Smart Thermostat,717,6160,11130,7552,1,2,ecobee_smart_thermostat-3,1069,3578
Ecobee Smart Thermostat,605,6020,11445,9411,4,5,ecobee_smart_thermostat-4,1070,2034
Ecobee Smart Thermostat,909,6440,11235,8646,2,2,ecobee_smart_thermostat-5,1071,2589
Ecobee Smart Thermostat,248,6790,11340,9634,4,5,ecobee_smart_thermostat-6,1072,1706
Ecobee Smart Thermostat,957,6860,11235,9704,5,4,ecobee_smart_thermostat-7,1073,1531
Ecobee Smart Thermostat,962,6860,11865,9939,3,1,ecobee_smart_thermostat-8,1074,1926
Ecobee Smart Thermostat,479,6860,10605,8583,2,2,ecobee_smart_thermostat-9,1075,2022
Ecobee Smart Thermostat,715,6720,10815,9096,3,2,ecobee_smart_thermostat-10,1076,1719
Ecobee Smart Thermostat,878,6580,11235,8512,2,3,ecobee_smart_thermostat-11,1077,2723
Ecobee Smart Thermostat,215,6510,10605,6920,1,5,ecobee_smart_thermostat-12,1078,3685
Ecobee Smart Thermostat,934,6790,10815,9709,5,1,ecobee_smart_thermostat-13,1079,1106
Ecobee Smart Thermostat,86,6580,11235,8722,2,2,ecobee_smart_thermostat-14,1080,2513
Ecobee Smart Thermostat,920,6650,11655,9729,3,1,ecobee_smart_thermostat-15,1081,1926
Ecobee Smart Thermostat,199,6370,11760,9874,4,4,ecobee_smart_thermostat-16,1082,1886
Ecobee Smart Thermostat,758,6860,12075,10250,4,4,ecobee_smart_thermostat-17,1083,1825
Ecobee Smart Thermostat,662,6510,11970,10196,5,3,ecobee_smart_thermostat-18,1084,1774
Ecobee Smart Thermostat,714,6930,11445,9211,2,1,ecobee_smart_thermostat-19,1085,2234
Ecobee Smart Thermostat,420,6510,11655,9134,3,4,ecobee_smart_thermostat-20,1086,2521
Ecobee Smart Thermostat,650,6860,10920,8363,2,4,ecobee_smart_thermostat-21,1087,2557
Samsung SmartThings Hub,876,4800,8025,6284,2,2,samsung_smartthings_hub-0,1088,1741
Samsung SmartThings Hub,903,4600,8325,7022,4,4,samsung_smartthings_hub-1,1089,1303
Samsung SmartThings Hub,223,4700,7725,6455,3,2,samsung_smartthings_hub-2,1090,1270
Samsung SmartThings Hub,510,4950,7575,5213,1,5,samsung_smartthings_hub-3,1091,2362
Samsung SmartThings Hub,896,4650,8475,7041,4,5,samsung_smartthings_hub-4,1092,1434
Samsung SmartThings Hub,299,4850,8475,7388,5,2,samsung_smartthings_hub-5,1093,1087
Samsung SmartThings Hub,312,4400,7725,6479,4,5,samsung_smartthings_hub-6,1094,1246
Samsung SmartThings Hub,414,4650,8325,6911,3,1,samsung_smartthings_hub-7,1095,1414
Samsung SmartThings Hub,893,4600,8175,7192,5,1,samsung_smartthings_hub-8,1096,983
Samsung SmartThings Hub,802,4300,7875,5999,3,5,samsung_smartthings_hub-9,1097,1876
Samsung SmartThings Hub,284,4900,8625,7601,5,1,samsung_smartthings_hub-10,1098,1024
Samsung SmartThings Hub,988,4650,7950,6168,2,2,samsung_smartthings_hub-11,1099,1782
Samsung SmartThings Hub,982,4850,8550,7348,5,3,samsung_smartthings_hub-12,1100,1202
Samsung SmartThings Hub,745,4400,7800,5148,1,3,samsung_smartthings_hub-13,1101,2652
Samsung SmartThings Hub,628,4300,8550,6957,5,5,samsung_smartthings_hub-14,1102,1593
Samsung SmartThings Hub,291,4600,8400,6519,2,1,samsung_smartthings_hub-15,1103,1881
Samsung SmartThings Hub,189,4600,8250,5622,1,2,samsung_smartthings_hub-16,1104,2628
Samsung SmartThings Hub,859,4700,8475,7437,5,1,samsung_smartthings_hub-17,1105,1038
Samsung SmartThings Hub,763,4750,8625,6010,2,5,samsung_smartthings_hub-18,1106,2615
Samsung SmartThings Hub,292,4400,7800,6610,5,4,samsung_smartthings_hub-19,1107,1190
Samsung SmartThings Hub,777,4900,7725,6539,3,2,samsung_smartthings_hub-20,1108,1186
August Smart Lock Pro,413,7650,14310,10414,2,3,august_smart_lock_pro-0,1109,3896
August Smart Lock Pro,829,8910,14040,10809,2,4,august_smart_lock_pro-1,1110,3231
August Smart Lock Pro,20,7830,14445,8492,1,5,august_smart_lock_pro-2,1111,5953
August Smart Lock Pro,610,8820,14310,12197,3,1,august_smart_lock_pro-3,1112,2113
August Smart Lock Pro,840,8010,15390,9191,1,4,august_smart_lock_pro-4,1113,6199
August Smart Lock Pro,568,8460,15255,11892,2,1,august_smart_lock_pro-5,1114,3363
August Smart Lock Pro,82,7920,13635,9178,1,3,august_smart_lock_pro-6,1115,4457
August Smart Lock Pro,763,7920,14850,12945,4,1,august_smart_lock_pro-7,1116,1905
August Smart Lock Pro,406,7920,14310,9710,1,2,august_smart_lock_pro-8,1117,4600
August Smart Lock Pro,763,8010,13770,10919,2,1,august_smart_lock_pro-9,1118,2851
August Smart Lock Pro,400,7650,14175,10750,3,5,august_smart_lock_pro-10,1119,3425
August Smart Lock Pro,287,8460,14985,11788,3,4,august_smart_lock_pro-11,1120,3197
August Smart Lock Pro,670,7650,15390,12488,5,5,august_smart_lock_pro-12,1121,2902
August Smart Lock Pro,616,8730,15120,13203,4,2,august_smart_lock_pro-13,1122,1917
August Smart Lock Pro,217,8190,14310,11954,3,1,august_smart_lock_pro-14,1123,2356
August Smart Lock Pro,898,8820,14310,11593,2,1,august_smart_lock_pro-15,1124,2717
August Smart Lock Pro,908,7650,14985,10034,2,5,august_smart_lock_pro-16,1125,4951
August Smart Lock Pro,120,7920,14445,12325,4,3,august_smart_lock_pro-17,1126,2120
August Smart Lock Pro,741,8550,14175,11138,2,2,august_smart_lock_pro-18,1127,3037
August Smart Lock Pro,372,8280,14310,12049,5,5,august_smart_lock_pro-19,1128,2261
August Smart Lock Pro,657,7650,13635,10404,2,2,august_smart_lock_pro-20,1129,3231
August Smart Lock Pro,81,7650,15255,12974,5,2,august_smart_lock_pro-21,1130,2281
August Smart Lock Pro,961,7650,14985,12968,4,1,august_smart_lock_pro-22,1131,2017
August Smart Lock Pro,270,8820,14040,10987,2,3,august_smart_lock_pro-23,1132,3053
August Smart Lock Pro,995,8550,14310,9126,1,5,august_smart_lock_pro-24,1133,5184
August Smart Lock Pro,111,8370,14445,11438,2,1,august_smart_lock_pro-25,1134,3007
August Smart Lock Pro,476,7920,13635,9178,1,3,august_smart_lock_pro-26,1135,4457
August Smart Lock Pro,135,8460,14445,12650,4,2,august_smart_lock_pro-27,1136,1795
August Smart Lock Pro,93,8640,14985,11876,3,4,august_smart_lock_pro-28,1137,3109
August Smart Lock Pro,91,8460,13905,12272,5,2,august_smart_lock_pro-29,1138,1633
LIFX Smart LED Strip,468,3395,5565,4003,1,2,lifx_smart_led_strip-0,1139,1562
LIFX Smart LED Strip,142,3395,5565,4860,4,3,lifx_smart_led_strip-1,1140,705
LIFX Smart LED Strip,61,2975,5355,4641,5,2,lifx_smart_led_strip-2,1141,714
LIFX Smart LED Strip,51,3080,5565,4820,5,2,lifx_smart_led_strip-3,1142,745
LIFX Smart LED Strip,633,3465,5407,4660,3,1,lifx_smart_led_strip-4,1143,747
LIFX Smart LED Strip,430,3220,5302,3991,2,4,lifx_smart_led_strip-5,1144,1311
LIFX Smart LED Strip,810,3395,5512,4465,2,1,lifx_smart_led_strip-6,1145,1047
LIFX Smart LED Strip,342,3360,5880,4293,2,4,lifx_smart_led_strip-7,1146,1587
LIFX Smart LED Strip,580,3325,5880,4271,2,4,lifx_smart_led_strip-8,1147,1609
LIFX Smart LED Strip,757,3080,5670,4311,3,5,lifx_smart_led_strip-9,1148,1359
LIFX Smart LED Strip,734,3395,5407,4422,3,4,lifx_smart_led_strip-10,1149,985
LIFX Smart LED Strip,363,3150,5302,4657,4,2,lifx_smart_led_strip-11,1150,645
LIFX Smart LED Strip,62,3150,5985,5206,4,1,lifx_smart_led_strip-12,1151,779
LIFX Smart LED Strip,581,3010,5722,4977,5,1,lifx_smart_led_strip-13,1152,745
LIFX Smart LED Strip,438,3325,5617,4105,1,1,lifx_smart_led_strip-14,1153,1512
LIFX Smart LED Strip,562,3150,5355,4066,2,3,lifx_smart_led_strip-15,1154,1289
LIFX Smart LED Strip,379,3290,5880,5103,5,2,lifx_smart_led_strip-16,1155,777
LIFX Smart LED Strip,401,3360,5460,4778,4,3,lifx_smart_led_strip-17,1156,682
LIFX Smart LED Strip,412,3395,5670,4635,3,3,lifx_smart_led_strip-18,1157,1035
LIFX Smart LED Strip,466,3045,5932,5066,5,2,lifx_smart_led_strip-19,1158,866
LIFX Smart LED Strip,162,3185,5302,4509,4,5,lifx_smart_led_strip-20,1159,793
LIFX Smart LED Strip,277,3255,5722,3946,1,2,lifx_smart_led_strip-21,1160,1776
LIFX Smart LED Strip,794,3010,5355,4593,4,3,lifx_smart_led_strip-22,1161,762
LIFX Smart LED Strip,750,3290,5407,4825,5,1,lifx_smart_led_strip-23,1162,582
Wyze Cam Pan,447,5880,9540,7399,2,3,wyze_cam_pan-0,1163,2141
Wyze Cam Pan,697,5880,10170,6567,1,4,wyze_cam_pan-1,1164,3603
Wyze Cam Pan,695,5760,9090,7842,5,5,wyze_cam_pan-2,1165,1248
Wyze Cam Pan,116,5340,9360,8154,4,2,wyze_cam_pan-3,1166,1206
Wyze Cam Pan,705,5280,9810,7160,2,3,wyze_cam_pan-4,1167,2650
Wyze Cam Pan,795,5700,9090,8073,5,2,wyze_cam_pan-5,1168,1017
Wyze Cam Pan,167,5640,10350,7878,3,5,wyze_cam_pan-6,1169,2472
Wyze Cam Pan,394,5940,10350,8917,5,3,wyze_cam_pan-7,1170,1433
Wyze Cam Pan,776,5880,10350,8674,4,5,wyze_cam_pan-8,1171,1676
Wyze Cam Pan,278,5220,10350,8811,4,2,wyze_cam_pan-9,1172,1539
Wyze Cam Pan,566,5220,10170,6309,1,3,wyze_cam_pan-10,1173,3861
Wyze Cam Pan,553,5400,9360,8073,4,3,wyze_cam_pan-11,1174,1287
Wyze Cam Pan,889,5280,9810,8225,4,4,wyze_cam_pan-12,1175,1585
Wyze Cam Pan,476,5940,9990,8775,4,2,wyze_cam_pan-13,1176,1215
Wyze Cam Pan,397,5880,9900,8795,5,1,wyze_cam_pan-14,1177,1105
Wyze Cam Pan,30,5520,10260,7274,2,4,wyze_cam_pan-15,1178,2986
Wyze Cam Pan,713,5280,9180,7815,5,4,wyze_cam_pan-16,1179,1365
Wyze Cam Pan,725,5460,10350,7123,1,1,wyze_cam_pan-17,1180,3227
Wyze Cam Pan,957,5700,9450,8232,4,3,wyze_cam_pan-18,1181,1218
Wyze Cam Pan,990,5160,9630,8178,4,3,wyze_cam_pan-19,1182,1452
Roomba i7+ Robot Vacuum,847,59400,98100,71978,2,5,roomba_i7_robot_vacuum-0,1183,26122
Roomba i7+ Robot Vacuum,117,56400,102600,87585,4,3,roomba_i7_robot_vacuum-1,1184,15015
Roomba i7+ Robot Vacuum,387,51600,95400,65835,2,5,roomba_i7_robot_vacuum-2,1185,29565
Roomba i7+ Robot Vacuum,228,57000,95400,70056,1,1,roomba_i7_robot_vacuum-3,1186,25344
Roomba i7+ Robot Vacuum,759,53400,93600,80535,4,3,roomba_i7_robot_vacuum-4,1187,13065
Roomba i7+ Robot Vacuum,903,57000,99900,87030,4,2,roomba_i7_robot_vacuum-5,1188,12870
Roomba i7+ Robot Vacuum,201,51000,98100,72666,2,2,roomba_i7_robot_vacuum-6,1189,25434
Roomba i7+ Robot Vacuum,979,58800,103500,65952,1,4,roomba_i7_robot_vacuum-7,1190,37548
Roomba i7+ Robot Vacuum,853,54600,102600,59400,1,5,roomba_i7_robot_vacuum-8,1191,43200
Roomba i7+ Robot Vacuum,228,51600,98100,70898,2,3,roomba_i7_robot_vacuum-9,1192,27202
Roomba i7+ Robot Vacuum,61,52800,96300,82163,5,3,roomba_i7_robot_vacuum-10,1193,14137
Roomba i7+ Robot Vacuum,324,51000,97200,82185,5,3,roomba_i7_robot_vacuum-11,1194,15015
Roomba i7+ Robot Vacuum,228,57000,92700,81990,5,2,roomba_i7_robot_vacuum-12,1195,10710
Roomba i7+ Robot Vacuum,664,56400,98100,86633,4,1,roomba_i7_robot_vacuum-13,1196,11467
Roomba i7+ Robot Vacuum,33,56400,99900,81630,3,2,roomba_i7_robot_vacuum-14,1197,18270
Roomba i7+ Robot Vacuum,892,59400,102600,90720,4,1,roomba_i7_robot_vacuum-15,1198,11880
Roomba i7+ Robot Vacuum,281,51000,90900,59778,1,3,roomba_i7_robot_vacuum-16,1199,31122
Roomba i7+ Robot Vacuum,477,58200,99000,79008,3,4,roomba_i7_robot_vacuum-17,1200,19992
Roomba i7+ Robot Vacuum,475,54000,97200,74521,3,5,roomba_i7_robot_vacuum-18,1201,22679
Roomba i7+ Robot Vacuum,256,54600,99000,59040,1,5,roomba_i7_robot_vacuum-19,1202,39960
Roomba i7+ Robot Vacuum,901,53400,95400,62640,1,3,roomba_i7_robot_vacuum-20,1203,32760
Roomba i7+ Robot Vacuum,552,53400,91800,61848,1,3,roomba_i7_robot_vacuum-21,1204,29952
Roomba i7+ Robot Vacuum,359,59400,102600,79272,2,2,roomba_i7_robot_vacuum-22,1205,23328
Roomba i7+ Robot Vacuum,310,54600,96300,81705,5,4,roomba_i7_robot_vacuum-23,1206,14595
Roomba i7+ Robot Vacuum,578,54000,103500,77513,3,5,roomba_i7_robot_vacuum-24,1207,25987
Roomba i7+ Robot Vacuum,591,55800,97200,81675,5,5,roomba_i7_robot_vacuum-25,1208,15525
Roomba i7+ Robot Vacuum,981,51600,96300,68139,2,4,roomba_i7_robot_vacuum-26,1209,28161
Roomba i7+ Robot Vacuum,382,58800,102600,89460,4,2,roomba_i7_robot_vacuum-27,1210,13140
Roomba i7+ Robot Vacuum,911,52800,92700,71154,2,2,roomba_i7_robot_vacuum-28,1211,21546
Roomba i7+ Robot Vacuum,460,57000,93600,79509,3,1,roomba_i7_robot_vacuum-29,1212,14091
Nest Learning Thermostat,585,8600,16800,11265,2,5,nest_learning_thermostat-0,1213,5535
Nest Learning Thermostat,969,9900,16350,13867,3,1,nest_learning_thermostat-1,1214,2483
Nest Learning Thermostat,325,8700,15150,12893,5,4,nest_learning_thermostat-2,1215,2257
Nest Learning Thermostat,628,9400,16350,11659,2,5,nest_learning_thermostat-3,1216,4691
Nest Learning Thermostat,156,9500,16050,13758,5,4,nest_learning_thermostat-4,1217,2292
Nest Learning Thermostat,589,8500,15900,10905,2,5,nest_learning_thermostat-5,1218,4995
Nest Learning Thermostat,999,9100,15300,13285,4,3,nest_learning_thermostat-6,1219,2015
Nest Learning Thermostat,160,9200,15750,10248,1,4,nest_learning_thermostat-7,1220,5502
Nest Learning Thermostat,367,9700,15600,10644,1,4,nest_learning_thermostat-8,1221,4956
Nest Learning Thermostat,175,8900,16050,12189,2,2,nest_learning_thermostat-9,1222,3861
Nest Learning Thermostat,618,9700,15150,10572,1,4,nest_learning_thermostat-10,1223,4578
Nest Learning Thermostat,936,8700,17250,14044,5,5,nest_learning_thermostat-11,1224,3206
Nest Learning Thermostat,39,9700,16050,14145,4,2,nest_learning_thermostat-12,1225,1905
Nest Learning Thermostat,561,8500,16950,12514,3,5,nest_learning_thermostat-13,1226,4436
Nest Learning Thermostat,892,8500,16500,12860,3,3,nest_learning_thermostat-14,1227,3640
Nest Learning Thermostat,107,9300,15450,12437,3,4,nest_learning_thermostat-15,1228,3013
Nest Learning Thermostat,735,8900,16650,13938,4,4,nest_learning_thermostat-16,1229,2712
Nest Learning Thermostat,511,8900,15450,11127,1,1,nest_learning_thermostat-17,1230,4323
Nest Learning Thermostat,725,8800,15300,11010,1,1,nest_learning_thermostat-18,1231,4290
Nest Learning Thermostat,886,9400,16950,14497,5,3,nest_learning_thermostat-19,1232,2453
Nest Learning Thermostat,801,9600,15750,12429,2,2,nest_learning_thermostat-20,1233,3321
Nest Learning Thermostat,439,8700,16950,11505,1,1,nest_learning_thermostat-21,1234,5445
Nest Learning Thermostat,91,9900,16350,11706,1,2,nest_learning_thermostat-22,1235,4644
Nest Learning Thermostat,190,8900,15450,11619,2,3,nest_learning_thermostat-23,1236,3831
Nest Learning Thermostat,947,9900,15600,11753,2,5,nest_learning_thermostat-24,1237,3847
Ring Spotlight Cam,171,11760,19440,16484,3,1,ring_spotlight_cam-0,1238,2956
Ring Spotlight Cam,313,10560,19980,15365,3,4,ring_spotlight_cam-1,1239,4615
Ring Spotlight Cam,824,11400,19980,15347,2,2,ring_spotlight_cam-2,1240,4633
Ring Spotlight Cam,812,11040,19080,14377,2,3,ring_spotlight_cam-3,1241,4703
Ring Spotlight Cam,998,10440,18180,12143,1,3,ring_spotlight_cam-4,1242,6037
Ring Spotlight Cam,577,10200,20160,17172,4,2,ring_spotlight_cam-5,1243,2988
Ring Spotlight Cam,411,11760,19440,16752,5,4,ring_spotlight_cam-6,1244,2688
Ring Spotlight Cam,931,11760,19440,13450,1,3,ring_spotlight_cam-7,1245,5990
Ring Spotlight Cam,144,11400,19260,14073,1,1,ring_spotlight_cam-8,1246,5187
Ring Spotlight Cam,727,10920,18720,16185,4,3,ring_spotlight_cam-9,1247,2535
Ring Spotlight Cam,588,10680,20340,16718,5,5,ring_spotlight_cam-10,1248,3622
Ring Spotlight Cam,243,11400,20520,16052,3,4,ring_spotlight_cam-11,1249,4468
Ring Spotlight Cam,315,10200,20160,13437,2,5,ring_spotlight_cam-12,1250,6723
Ring Spotlight Cam,228,10200,19080,13220,1,1,ring_spotlight_cam-13,1251,5860
Ring Spotlight Cam,349,11880,19980,14877,2,4,ring_spotlight_cam-14,1252,5103
Ring Spotlight Cam,394,11280,20340,17396,4,3,ring_spotlight_cam-15,1253,2944
Ring Spotlight Cam,148,10320,18360,14381,2,1,ring_spotlight_cam-16,1254,3979
Ring Spotlight Cam,662,11760,18180,13847,2,5,ring_spotlight_cam-17,1255,4333
Ring Spotlight Cam,528,11160,20160,14895,2,3,ring_spotlight_cam-18,1256,5265
Ring Spotlight Cam,257,10440,18720,15822,4,4,ring_spotlight_cam-19,1257,2898
Ring Spotlight Cam,46,11160,19620,16659,4,4,ring_spotlight_cam-20,1258,2961
Ring Spotlight Cam,59,11880,18180,15975,4,4,ring_spotlight_cam-21,1259,2205
Ring Spotlight Cam,886,10560,20160,14112,2,4,ring_spotlight_cam-22,1260,6048
TP-Link Kasa Smart Plug,221,1720,3270,2503,2,1,tplink_kasa_smart_plug-0,1261,767
TP-Link Kasa Smart Plug,283,1780,3450,2749,3,2,tplink_kasa_smart_plug-1,1262,701
TP-Link Kasa Smart Plug,311,1800,3120,2658,5,4,tplink_kasa_smart_plug-2,1263,462
TP-Link Kasa Smart Plug,307,1860,3300,2393,2,4,tplink_kasa_smart_plug-3,1264,907
TP-Link Kasa Smart Plug,563,1980,3240,2711,3,2,tplink_kasa_smart_plug-4,1265,529
TP-Link Kasa Smart Plug,427,1740,3090,2118,1,2,tplink_kasa_smart_plug-5,1266,972
TP-Link Kasa Smart Plug,270,1700,3030,2379,3,4,tplink_kasa_smart_plug-6,1267,651
TP-Link Kasa Smart Plug,436,1960,3330,2817,4,5,tplink_kasa_smart_plug-7,1268,513
TP-Link Kasa Smart Plug,848,1820,3090,2646,4,4,tplink_kasa_smart_plug-8,1269,444
TP-Link Kasa Smart Plug,103,1920,3150,2689,4,5,tplink_kasa_smart_plug-9,1270,461
TP-Link Kasa Smart Plug,960,1940,3150,2515,3,5,tplink_kasa_smart_plug-10,1271,635
TP-Link Kasa Smart Plug,524,1980,3390,3003,5,1,tplink_kasa_smart_plug-11,1272,387
TP-Link Kasa Smart Plug,387,1700,3360,2738,4,5,tplink_kasa_smart_plug-12,1273,622
TP-Link Kasa Smart Plug,532,1780,3330,2493,2,2,tplink_kasa_smart_plug-13,1274,837
TP-Link Kasa Smart Plug,62,1760,3270,2636,3,2,tplink_kasa_smart_plug-14,1275,634
TP-Link Kasa Smart Plug,269,1820,3120,2243,2,5,tplink_kasa_smart_plug-15,1276,877
TP-Link Kasa Smart Plug,997,1920,3330,2590,3,5,tplink_kasa_smart_plug-16,1277,740
TP-Link Kasa Smart Plug,517,1720,3090,2351,2,2,tplink_kasa_smart_plug-17,1278,739
TP-Link Kasa Smart Plug,545,1800,3180,2249,2,5,tplink_kasa_smart_plug-18,1279,931
TP-Link Kasa Smart Plug,477,1780,3240,1926,1,5,tplink_kasa_smart_plug-19,1280,1314
TP-Link Kasa Smart Plug,957,1940,3150,2757,4,3,tplink_kasa_smart_plug-20,1281,393
TP-Link Kasa Smart Plug,378,1860,3420,2508,2,3,tplink_kasa_smart_plug-21,1282,912
TP-Link Kasa Smart Plug,549,1760,3360,2880,5,2,tplink_kasa_smart_plug-22,1283,480
TP-Link Kasa Smart Plug,230,1760,3330,2483,2,2,tplink_kasa_smart_plug-23,1284,847
TP-Link Kasa Smart Plug,160,1900,3270,2037,1,5,tplink_kasa_smart_plug-24,1285,1233
TP-Link Kasa Smart Plug,555,1880,3450,2037,1,5,tplink_kasa_smart_plug-25,1286,1413
Amazon Echo Show 10 (3rd Gen),227,13350,25650,21345,4,4,amazon_echo_show_10_3rd_gen-0,1287,4305
Amazon Echo Show 10 (3rd Gen),129,14850,24750,20592,3,2,amazon_echo_show_10_3rd_gen-1,1288,4158
Amazon Echo Show 10 (3rd Gen),35,12900,23850,17445,2,3,amazon_echo_show_10_3rd_gen-2,1289,6405
Amazon Echo Show 10 (3rd Gen),654,12900,24975,20749,5,4,amazon_echo_show_10_3rd_gen-3,1290,4226
Amazon Echo Show 10 (3rd Gen),603,12900,23400,16785,2,4,amazon_echo_show_10_3rd_gen-4,1291,6615
Amazon Echo Show 10 (3rd Gen),904,12900,24075,21002,5,1,amazon_echo_show_10_3rd_gen-5,1292,3073
Amazon Echo Show 10 (3rd Gen),489,14850,25425,17811,1,2,amazon_echo_show_10_3rd_gen-6,1293,7614
Amazon Echo Show 10 (3rd Gen),686,14100,23625,17196,2,5,amazon_echo_show_10_3rd_gen-7,1294,6429
Amazon Echo Show 10 (3rd Gen),907,13650,23850,15894,1,3,amazon_echo_show_10_3rd_gen-8,1295,7956
Amazon Echo Show 10 (3rd Gen),671,12900,25875,21983,5,2,amazon_echo_show_10_3rd_gen-9,1296,3892
Amazon Echo Show 10 (3rd Gen),154,13800,25425,16358,1,3,amazon_echo_show_10_3rd_gen-10,1297,9067
Amazon Echo Show 10 (3rd Gen),746,13950,23400,18770,3,4,amazon_echo_show_10_3rd_gen-11,1298,4630
Amazon Echo Show 10 (3rd Gen),620,14100,23400,17123,2,5,amazon_echo_show_10_3rd_gen-12,1299,6277
Amazon Echo Show 10 (3rd Gen),855,12900,23625,17834,2,2,amazon_echo_show_10_3rd_gen-13,1300,5791
Amazon Echo Show 10 (3rd Gen),298,13950,22950,16875,2,5,amazon_echo_show_10_3rd_gen-14,1301,6075
Amazon Echo Show 10 (3rd Gen),137,13950,25425,21409,5,4,amazon_echo_show_10_3rd_gen-15,1302,4016
Amazon Echo Show 10 (3rd Gen),240,13800,23625,19155,3,3,amazon_echo_show_10_3rd_gen-16,1303,4470
Amazon Echo Show 10 (3rd Gen),854,14400,24525,17843,1,1,amazon_echo_show_10_3rd_gen-17,1304,6682
Amazon Echo Show 10 (3rd Gen),436,13500,24075,16937,2,5,amazon_echo_show_10_3rd_gen-18,1305,7138
Amazon Echo Show 10 (3rd Gen),534,12750,25200,19971,3,2,amazon_echo_show_10_3rd_gen-19,1306,5229
Amazon Echo Show 10 (3rd Gen),986,13350,25425,21803,4,2,amazon_echo_show_10_3rd_gen-20,1307,3622
Amazon Echo Show 10 (3rd Gen),813,14100,24300,15120,1,5,amazon_echo_show_10_3rd_gen-21,1308,9180
Amazon Echo Show 10 (3rd Gen),582,12750,23850,17357,2,3,amazon_echo_show_10_3rd_gen-22,1309,6493
Amazon Echo Show 10 (3rd Gen),855,14850,24750,18216,1,1,amazon_echo_show_10_3rd_gen-23,1310,6534
Amazon Echo Show 10 (3rd Gen),24,14850,25875,22568,4,2,amazon_echo_show_10_3rd_gen-24,1311,3307
Amazon Echo Show 10 (3rd Gen),108,12750,24975,21614,5,1,amazon_echo_show_10_3rd_gen-25,1312,3361
Arlo Pro 3 Security Camera,967,17100,27810,22509,2,1,arlo_pro_3_security_camera-0,1313,5301
Arlo Pro 3 Security Camera,564,17280,29430,20682,1,2,arlo_pro_3_security_camera-1,1314,8748
Arlo Pro 3 Security Camera,787,15840,31050,23065,3,5,arlo_pro_3_security_camera-2,1315,7985
Arlo Pro 3 Security Camera,634,17280,29970,26163,4,2,arlo_pro_3_security_camera-3,1316,3807
Arlo Pro 3 Security Camera,618,17820,28620,23706,3,3,arlo_pro_3_security_camera-4,1317,4914
Arlo Pro 3 Security Camera,337,15840,27270,19727,1,1,arlo_pro_3_security_camera-5,1318,7543
Arlo Pro 3 Security Camera,373,17820,29700,22216,2,4,arlo_pro_3_security_camera-6,1319,7484
Arlo Pro 3 Security Camera,615,15840,27540,18414,1,3,arlo_pro_3_security_camera-7,1320,9126
Arlo Pro 3 Security Camera,224,16740,27540,19116,1,3,arlo_pro_3_security_camera-8,1321,8424
Arlo Pro 3 Security Camera,680,17100,29700,19116,1,4,arlo_pro_3_security_camera-9,1322,10584
Arlo Pro 3 Security Camera,20,16740,28890,23787,3,2,arlo_pro_3_security_camera-10,1323,5103
Arlo Pro 3 Security Camera,741,17280,27270,19478,1,3,arlo_pro_3_security_camera-11,1324,7792
Arlo Pro 3 Security Camera,460,17820,28620,21492,1,1,arlo_pro_3_security_camera-12,1325,7128
Arlo Pro 3 Security Camera,786,15660,28890,22871,3,3,arlo_pro_3_security_camera-13,1326,6019
Arlo Pro 3 Security Camera,26,16380,28890,25137,4,2,arlo_pro_3_security_camera-14,1327,3753
Arlo Pro 3 Security Camera,518,15480,30510,21718,2,3,arlo_pro_3_security_camera-15,1328,8792
Arlo Pro 3 Security Camera,963,15660,28890,23797,3,1,arlo_pro_3_security_camera-16,1329,5093
Arlo Pro 3 Security Camera,696,15660,29970,19667,1,2,arlo_pro_3_security_camera-17,1330,10303
Arlo Pro 3 Security Camera,632,17100,27270,18117,1,5,arlo_pro_3_security_camera-18,1331,9153
Arlo Pro 3 Security Camera,194,15840,28350,24910,5,1,arlo_pro_3_security_camera-19,1332,3440
Arlo Pro 3 Security Camera,746,17820,27270,24672,5,1,arlo_pro_3_security_camera-20,1333,2598
Arlo Pro 3 Security Camera,344,17820,30780,23199,2,3,arlo_pro_3_security_camera-21,1334,7581
Arlo Pro 3 Security Camera,972,15660,29160,23963,3,1,arlo_pro_3_security_camera-22,1335,5197
Arlo Pro 3 Security Camera,507,16020,30240,23770,3,3,arlo_pro_3_security_camera-23,1336,6470
Arlo Pro 3 Security Camera,139,17820,28080,20693,1,2,arlo_pro_3_security_camera-24,1337,7387
Arlo Pro 3 Security Camera,195,15480,28080,24300,5,2,arlo_pro_3_security_camera-25,1338,3780
Wemo Smart Light Switch,134,2850,5085,4471,5,1,wemo_smart_light_switch-0,1339,614
Wemo Smart Light Switch,582,2700,4860,3305,1,2,wemo_smart_light_switch-1,1340,1555
Wemo Smart Light Switch,137,2700,4905,3516,2,4,wemo_smart_light_switch-2,1341,1389
Wemo Smart Light Switch,835,2550,4995,3969,3,2,wemo_smart_light_switch-3,1342,1026
Wemo Smart Light Switch,608,2790,4995,4147,3,1,wemo_smart_light_switch-4,1343,848
Wemo Smart Light Switch,591,2850,5175,3083,1,5,wemo_smart_light_switch-5,1344,2092
Wemo Smart Light Switch,181,2640,4950,4142,5,4,wemo_smart_light_switch-6,1345,808
Wemo Smart Light Switch,495,2640,4545,3431,2,3,wemo_smart_light_switch-7,1346,1114
Wemo Smart Light Switch,982,2790,4725,3681,2,2,wemo_smart_light_switch-8,1347,1044
Wemo Smart Light Switch,659,2820,4725,4059,5,4,wemo_smart_light_switch-9,1348,666
Wemo Smart Light Switch,136,2730,5040,3100,1,4,wemo_smart_light_switch-10,1349,1940
Wemo Smart Light Switch,558,2970,4545,3411,1,2,wemo_smart_light_switch-11,1350,1134
Wemo Smart Light Switch,346,2700,4815,3420,1,1,wemo_smart_light_switch-12,1351,1395
Wemo Smart Light Switch,346,2790,4770,4077,5,4,wemo_smart_light_switch-13,1352,693
Wemo Smart Light Switch,191,2700,4860,4158,4,3,wemo_smart_light_switch-14,1353,702
Wemo Smart Light Switch,700,2730,4860,4168,5,3,wemo_smart_light_switch-15,1354,692
Wemo Smart Light Switch,147,2880,5085,4424,5,2,wemo_smart_light_switch-16,1355,661
Wemo Smart Light Switch,334,2550,4815,3943,3,1,wemo_smart_light_switch-17,1356,872
Wemo Smart Light Switch,464,2820,5175,3480,1,2,wemo_smart_light_switch-18,1357,1695
Wemo Smart Light Switch,147,2730,4770,3393,2,5,wemo_smart_light_switch-19,1358,1377
Wemo Smart Light Switch,215,2940,4680,3506,2,5,wemo_smart_light_switch-20,1359,1174
Wemo Smart Light Switch,839,2790,4815,4208,4,2,wemo_smart_light_switch-21,1360,607
Wemo Smart Light Switch,508,2970,4590,3327,1,3,wemo_smart_light_switch-22,1361,1263
Wemo Smart Light Switch,361,2820,5040,4430,4,1,wemo_smart_light_switch-23,1362,610
Wemo Smart Light Switch,768,2910,5040,4455,5,1,wemo_smart_light_switch-24,1363,585
Wemo Smart Light Switch,785,2640,4545,3831,4,5,wemo_smart_light_switch-25,1364,714
Google Nest Protect Smoke Detector,778,7600,13320,10318,3,5,google_nest_protect_smoke_detector-0,1365,3002
Google Nest Protect Smoke Detector,418,7600,12600,10125,2,1,google_nest_protect_smoke_detector-1,1366,2475
Google Nest Protect Smoke Detector,818,7280,13680,11280,5,5,google_nest_protect_smoke_detector-2,1367,2400
Google Nest Protect Smoke Detector,125,7120,12960,9807,2,2,google_nest_protect_smoke_detector-3,1368,3153
Google Nest Protect Smoke Detector,639,7200,13680,10473,2,1,google_nest_protect_smoke_detector-4,1369,3207
Google Nest Protect Smoke Detector,180,7440,13080,11247,5,3,google_nest_protect_smoke_detector-5,1370,1833
Google Nest Protect Smoke Detector,405,7600,13800,11785,4,3,google_nest_protect_smoke_detector-6,1371,2015
Google Nest Protect Smoke Detector,378,7840,12960,10272,3,5,google_nest_protect_smoke_detector-7,1372,2688
Google Nest Protect Smoke Detector,130,7120,12240,10090,3,2,google_nest_protect_smoke_detector-8,1373,2150
Google Nest Protect Smoke Detector,304,7840,12720,9500,1,1,google_nest_protect_smoke_detector-9,1374,3220
Google Nest Protect Smoke Detector,674,7840,12120,10023,3,4,google_nest_protect_smoke_detector-10,1375,2097
Google Nest Protect Smoke Detector,546,7280,12720,10055,3,4,google_nest_protect_smoke_detector-11,1376,2665
Google Nest Protect Smoke Detector,638,7600,12720,10212,3,4,google_nest_protect_smoke_detector-12,1377,2508
Google Nest Protect Smoke Detector,481,7280,13560,11205,4,5,google_nest_protect_smoke_detector-13,1378,2355
Google Nest Protect Smoke Detector,734,7920,13320,10486,3,5,google_nest_protect_smoke_detector-14,1379,2834
Google Nest Protect Smoke Detector,896,7760,12720,8256,1,5,google_nest_protect_smoke_detector-15,1380,4464
Google Nest Protect Smoke Detector,470,7280,13560,11205,4,5,google_nest_protect_smoke_detector-16,1381,2355
Google Nest Protect Smoke Detector,233,7040,13200,10613,3,2,google_nest_protect_smoke_detector-17,1382,2587
Google Nest Protect Smoke Detector,931,6880,12960,9404,2,3,google_nest_protect_smoke_detector-18,1383,3556
Google Nest Protect Smoke Detector,606,7120,13320,10282,3,4,google_nest_protect_smoke_detector-19,1384,3038
Google Nest Protect Smoke Detector,150,7600,12600,11100,4,2,google_nest_protect_smoke_detector-20,1385,1500
Google Nest Protect Smoke Detector,940,7920,12960,9634,1,1,google_nest_protect_smoke_detector-21,1386,3326
Google Nest Protect Smoke Detector,334,7680,12120,10788,4,2,google_nest_protect_smoke_detector-22,1387,1332
Google Nest Protect Smoke Detector,832,7360,12120,7836,1,5,google_nest_protect_smoke_detector-23,1388,4284
Sonos One Smart Speaker,904,11880,19440,17361,5,1,sonos_one_smart_speaker-0,1389,2079
Sonos One Smart Speaker,337,10920,19260,13756,1,1,sonos_one_smart_speaker-1,1390,5504
Sonos One Smart Speaker,908,11760,19980,17720,5,1,sonos_one_smart_speaker-2,1391,2260
Sonos One Smart Speaker,845,10920,18180,16184,4,1,sonos_one_smart_speaker-3,1392,1996
Sonos One Smart Speaker,492,10800,19260,13169,1,2,sonos_one_smart_speaker-4,1393,6091
Sonos One Smart Speaker,151,10680,19620,15240,3,4,sonos_one_smart_speaker-5,1394,4380
Sonos One Smart Speaker,48,10920,18720,16185,4,3,sonos_one_smart_speaker-6,1395,2535
Sonos One Smart Speaker,738,11280,20340,17169,4,4,sonos_one_smart_speaker-7,1396,3171
Sonos One Smart Speaker,550,10200,19260,16769,4,1,sonos_one_smart_speaker-8,1397,2491
Sonos One Smart Speaker,699,10560,19800,16335,5,5,sonos_one_smart_speaker-9,1398,3465
Sonos One Smart Speaker,925,10560,18900,16607,4,1,sonos_one_smart_speaker-10,1399,2293
Sonos One Smart Speaker,45,10920,19080,15041,2,1,sonos_one_smart_speaker-11,1400,4039
Sonos One Smart Speaker,625,11040,19620,16832,5,3,sonos_one_smart_speaker-12,1401,2788
Sonos One Smart Speaker,672,11160,18720,11916,1,5,sonos_one_smart_speaker-13,1402,6804
Sonos One Smart Speaker,224,11280,20340,17849,4,1,sonos_one_smart_speaker-14,1403,2491
Sonos One Smart Speaker,230,11160,19260,17033,4,1,sonos_one_smart_speaker-15,1404,2227
Sonos One Smart Speaker,464,11160,19440,12485,1,4,sonos_one_smart_speaker-16,1405,6955
Sonos One Smart Speaker,245,11880,19620,14744,2,4,sonos_one_smart_speaker-17,1406,4876
Sonos One Smart Speaker,662,11760,20700,13727,1,3,sonos_one_smart_speaker-18,1407,6973
Sonos One Smart Speaker,982,11640,20700,13634,1,3,sonos_one_smart_speaker-19,1408,7066
Sonos One Smart Speaker,593,10320,20340,14930,2,2,sonos_one_smart_speaker-20,1409,5410
Sonos One Smart Speaker,751,11520,18180,16182,4,2,sonos_one_smart_speaker-21,1410,1998
Sonos One Smart Speaker,458,11520,19080,16623,4,3,sonos_one_smart_speaker-22,1411,2457
Sonos One Smart Speaker,578,11160,19620,13022,1,3,sonos_one_smart_speaker-23,1412,6598
Eufy RoboVac 11S Robot Vacuum,436,21250,39000,28617,2,3,eufy_robovac_11s_robot_vacuum-0,1413,10383
Eufy RoboVac 11S Robot Vacuum,746,23750,41625,31169,2,3,eufy_robovac_11s_robot_vacuum-1,1414,10456
Eufy RoboVac 11S Robot Vacuum,244,22500,42000,26790,1,3,eufy_robovac_11s_robot_vacuum-2,1415,15210
Eufy RoboVac 11S Robot Vacuum,331,24000,41625,34840,3,1,eufy_robovac_11s_robot_vacuum-3,1416,6785
Eufy RoboVac 11S Robot Vacuum,416,21250,40125,24270,1,4,eufy_robovac_11s_robot_vacuum-4,1417,15855
Eufy RoboVac 11S Robot Vacuum,528,24000,40125,35691,5,1,eufy_robovac_11s_robot_vacuum-5,1418,4434
Eufy RoboVac 11S Robot Vacuum,652,22750,38625,33863,4,2,eufy_robovac_11s_robot_vacuum-6,1419,4762
Eufy RoboVac 11S Robot Vacuum,978,22000,40500,30788,3,5,eufy_robovac_11s_robot_vacuum-7,1420,9712
Eufy RoboVac 11S Robot Vacuum,584,24500,38625,32693,3,2,eufy_robovac_11s_robot_vacuum-8,1421,5932
Eufy RoboVac 11S Robot Vacuum,992,21750,38250,27855,2,4,eufy_robovac_11s_robot_vacuum-9,1422,10395
Eufy RoboVac 11S Robot Vacuum,84,23500,40125,30400,2,3,eufy_robovac_11s_robot_vacuum-10,1423,9725
Eufy RoboVac 11S Robot Vacuum,83,24250,41625,34936,3,1,eufy_robovac_11s_robot_vacuum-11,1424,6689
Eufy RoboVac 11S Robot Vacuum,675,23000,42750,37319,5,1,eufy_robovac_11s_robot_vacuum-12,1425,5431
Eufy RoboVac 11S Robot Vacuum,334,24250,42000,36232,4,3,eufy_robovac_11s_robot_vacuum-13,1426,5768
Eufy RoboVac 11S Robot Vacuum,841,23750,38250,31073,2,1,eufy_robovac_11s_robot_vacuum-14,1427,7177
Eufy RoboVac 11S Robot Vacuum,646,22750,39750,35075,5,1,eufy_robovac_11s_robot_vacuum-15,1428,4675
Eufy RoboVac 11S Robot Vacuum,211,22250,42000,34594,4,5,eufy_robovac_11s_robot_vacuum-16,1429,7406
Eufy RoboVac 11S Robot Vacuum,26,21250,41625,23288,1,5,eufy_robovac_11s_robot_vacuum-17,1430,18337
Eufy RoboVac 11S Robot Vacuum,759,23000,40125,34560,4,3,eufy_robovac_11s_robot_vacuum-18,1431,5565
Eufy RoboVac 11S Robot Vacuum,48,23000,40125,32933,3,2,eufy_robovac_11s_robot_vacuum-19,1432,7192
Eufy RoboVac 11S Robot Vacuum,784,24000,41625,33606,3,3,eufy_robovac_11s_robot_vacuum-20,1433,8019
Eufy RoboVac 11S Robot Vacuum,545,21750,41625,31787,2,1,eufy_robovac_11s_robot_vacuum-21,1434,9838
Eufy RoboVac 11S Robot Vacuum,655,24250,43125,37463,5,2,eufy_robovac_11s_robot_vacuum-22,1435,5662
Eufy RoboVac 11S Robot Vacuum,459,21250,40500,23175,1,5,eufy_robovac_11s_robot_vacuum-23,1436,17325
Apple MacBook Pro (13-inch),205,82800,144450,122873,4,4,apple_macbook_pro_13inch-0,1437,21577
Apple MacBook Pro (13-inch),79,87300,151200,117653,3,5,apple_macbook_pro_13inch-1,1438,33547
Apple MacBook Pro (13-inch),460,87300,153900,133920,5,2,apple_macbook_pro_13inch-2,1439,19980
Apple MacBook Pro (13-inch),381,86400,151200,108432,1,1,apple_macbook_pro_13inch-3,1440,42768
Apple MacBook Pro (13-inch),180,85500,147150,124032,4,5,apple_macbook_pro_13inch-4,1441,23118
Apple MacBook Pro (13-inch),220,83700,137700,106110,2,3,apple_macbook_pro_13inch-5,1442,31590
Apple MacBook Pro (13-inch),315,87300,139050,124819,4,1,apple_macbook_pro_13inch-6,1443,14231
Apple MacBook Pro (13-inch),557,85500,144450,94932,1,4,apple_macbook_pro_13inch-7,1444,49518
Apple MacBook Pro (13-inch),475,89100,144450,125078,5,4,apple_macbook_pro_13inch-8,1445,19372
Apple MacBook Pro (13-inch),725,81000,137700,99428,2,5,apple_macbook_pro_13inch-9,1446,38272
Apple MacBook Pro (13-inch),660,84600,147150,123069,3,1,apple_macbook_pro_13inch-10,1447,24081
Apple MacBook Pro (13-inch),307,87300,145800,119183,3,3,apple_macbook_pro_13inch-11,1448,26617
Apple MacBook Pro (13-inch),809,89100,139050,119820,3,1,apple_macbook_pro_13inch-12,1449,19230
Apple MacBook Pro (13-inch),268,78300,152550,90180,1,4,apple_macbook_pro_13inch-13,1450,62370
Apple MacBook Pro (13-inch),850,81000,143100,98388,1,2,apple_macbook_pro_13inch-14,1451,44712
Apple MacBook Pro (13-inch),79,78300,140400,117113,5,5,apple_macbook_pro_13inch-15,1452,23287
Apple MacBook Pro (13-inch),31,79200,136350,98631,1,1,apple_macbook_pro_13inch-16,1453,37719
Apple MacBook Pro (13-inch),394,86400,141750,98577,1,3,apple_macbook_pro_13inch-17,1454,43173
Apple MacBook Pro (13-inch),72,76500,139050,115594,5,5,apple_macbook_pro_13inch-18,1455,23456
Apple MacBook Pro (13-inch),381,82800,144450,124414,4,3,apple_macbook_pro_13inch-19,1456,20036
Apple MacBook Pro (13-inch),787,84600,152550,133864,4,1,apple_macbook_pro_13inch-20,1457,18686
Apple MacBook Pro (13-inch),50,78300,139050,117788,5,4,apple_macbook_pro_13inch-21,1458,21262
Apple MacBook Pro (13-inch),459,89100,139050,103086,1,2,apple_macbook_pro_13inch-22,1459,35964
Apple MacBook Pro (13-inch),399,82800,149850,124036,3,1,apple_macbook_pro_13inch-23,1460,25814
Apple MacBook Pro (13-inch),356,86400,141750,104389,2,5,apple_macbook_pro_13inch-24,1461,37361
Apple MacBook Pro (13-inch),138,79200,145800,122490,5,4,apple_macbook_pro_13inch-25,1462,23310
Apple MacBook Pro (13-inch),167,76500,151200,119826,3,2,apple_macbook_pro_13inch-26,1463,31374
Dell XPS 13,219,65100,116550,101115,5,2,dell_xps_13-0,1464,15435
Dell XPS 13,234,60900,116550,91230,3,3,dell_xps_13-1,1465,25320
Dell XPS 13,519,60900,119700,77364,1,2,dell_xps_13-2,1466,42336
Dell XPS 13,77,68600,107100,89583,3,3,dell_xps_13-3,1467,17517
Dell XPS 13,992,65800,119700,104878,5,1,dell_xps_13-4,1468,14822
Dell XPS 13,290,69300,116550,91744,3,5,dell_xps_13-5,1469,24806
Dell XPS 13,633,65800,110250,70245,1,5,dell_xps_13-6,1470,40005
Dell XPS 13,679,60200,117600,101815,4,1,dell_xps_13-7,1471,15785
Dell XPS 13,270,67900,113400,97475,4,4,dell_xps_13-8,1472,15925
Dell XPS 13,901,63000,115500,95288,3,1,dell_xps_13-9,1473,20212
Dell XPS 13,663,65800,114450,88179,2,2,dell_xps_13-10,1474,26271
Dell XPS 13,485,62300,116550,98919,4,3,dell_xps_13-11,1475,17631
Dell XPS 13,156,63000,119700,95886,3,2,dell_xps_13-12,1476,23814
Dell XPS 13,577,67900,111300,96110,5,4,dell_xps_13-13,1477,15190
Dell XPS 13,970,67200,112350,81874,2,5,dell_xps_13-14,1478,30476
Dell XPS 13,729,60200,110250,95235,5,2,dell_xps_13-15,1479,15015
Dell XPS 13,137,59500,112350,79055,2,4,dell_xps_13-16,1480,33295
Dell XPS 13,660,59500,116550,86599,3,5,dell_xps_13-17,1481,29951
Dell XPS 13,135,63000,113400,98280,4,2,dell_xps_13-18,1482,15120
Dell XPS 13,191,65100,117600,79800,1,2,dell_xps_13-19,1483,37800
Dell XPS 13,247,63000,118650,89434,3,5,dell_xps_13-20,1484,29216
Dell XPS 13,582,65100,106050,87418,3,3,dell_xps_13-21,1485,18632
Dell XPS 13,784,61600,117600,73920,1,3,dell_xps_13-22,1486,43680
Dell XPS 13,217,69300,119700,77364,1,4,dell_xps_13-23,1487,42336
HP Spectre x360,643,68800,128400,88170,2,5,hp_spectre_x360-0,1488,40230
HP Spectre x360,530,78400,130800,116390,5,1,hp_spectre_x360-1,1489,14410
HP Spectre x360,965,72000,134400,89472,1,2,hp_spectre_x360-2,1490,44928
HP Spectre x360,843,75200,138000,120730,5,1,hp_spectre_x360-3,1491,17270
HP Spectre x360,995,78400,133200,104430,3,5,hp_spectre_x360-4,1492,28770
HP Spectre x360,121,76000,127200,102112,3,4,hp_spectre_x360-5,1493,25088
HP Spectre x360,515,76800,129600,88416,1,3,hp_spectre_x360-6,1494,41184
HP Spectre x360,108,68000,130800,108820,4,4,hp_spectre_x360-7,1495,21980
HP Spectre x360,318,76000,121200,102216,3,2,hp_spectre_x360-8,1496,18984
HP Spectre x360,896,73600,126000,110280,5,2,hp_spectre_x360-9,1497,15720
HP Spectre x360,82,69600,133200,110940,5,4,hp_spectre_x360-10,1498,22260
HP Spectre x360,125,74400,130800,115290,4,1,hp_spectre_x360-11,1499,15510
HP Spectre x360,700,70400,133200,104626,3,3,hp_spectre_x360-12,1500,28574
HP Spectre x360,412,75200,130800,103556,3,4,hp_spectre_x360-13,1501,27244
HP Spectre x360,398,79200,132000,117480,4,1,hp_spectre_x360-14,1502,14520
HP Spectre x360,826,68000,136800,110312,3,1,hp_spectre_x360-15,1503,26488
HP Spectre x360,128,69600,138000,97986,2,3,hp_spectre_x360-16,1504,40014
HP Spectre x360,994,76800,134400,117120,5,2,hp_spectre_x360-17,1505,17280
HP Spectre x360,540,72000,133200,113310,4,3,hp_spectre_x360-18,1506,19890
HP Spectre x360,366,79200,134400,109284,3,3,hp_spectre_x360-19,1507,25116
HP Spectre x360,301,69600,134400,96492,2,3,hp_spectre_x360-20,1508,37908
HP Spectre x360,51,68000,124800,107760,4,2,hp_spectre_x360-21,1509,17040
HP Spectre x360,260,77600,135600,93840,1,2,hp_spectre_x360-22,1510,41760
HP Spectre x360,442,77600,133200,105678,2,1,hp_spectre_x360-23,1511,27522
HP Spectre x360,864,73600,123600,106100,5,4,hp_spectre_x360-24,1512,17500
HP Spectre x360,626,72800,121200,107890,4,1,hp_spectre_x360-25,1513,13310
HP Spectre x360,472,74400,126000,88848,1,2,hp_spectre_x360-26,1514,37152
HP Spectre x360,970,76000,135600,100734,2,3,hp_spectre_x360-27,1515,34866
Lenovo ThinkPad X1 Carbon,663,52200,102600,88740,4,1,lenovo_thinkpad_x1_carbon-0,1516,13860
Lenovo ThinkPad X1 Carbon,215,59400,92700,83543,4,1,lenovo_thinkpad_x1_carbon-1,1517,9157
Lenovo ThinkPad X1 Carbon,79,54600,100800,70308,1,1,lenovo_thinkpad_x1_carbon-2,1518,30492
Lenovo ThinkPad X1 Carbon,934,55200,100800,59760,1,5,lenovo_thinkpad_x1_carbon-3,1519,41040
Lenovo ThinkPad X1 Carbon,526,57600,90900,66924,1,2,lenovo_thinkpad_x1_carbon-4,1520,23976
Lenovo ThinkPad X1 Carbon,706,56400,95400,70830,2,4,lenovo_thinkpad_x1_carbon-5,1521,24570
Lenovo ThinkPad X1 Carbon,556,59400,96300,78219,3,4,lenovo_thinkpad_x1_carbon-6,1522,18081
Lenovo ThinkPad X1 Carbon,61,54000,97200,76032,3,4,lenovo_thinkpad_x1_carbon-7,1523,21168
Lenovo ThinkPad X1 Carbon,647,52800,100800,77280,3,4,lenovo_thinkpad_x1_carbon-8,1524,23520
Lenovo ThinkPad X1 Carbon,179,54000,103500,89888,4,1,lenovo_thinkpad_x1_carbon-9,1525,13612
Lenovo ThinkPad X1 Carbon,34,51600,95400,63864,1,2,lenovo_thinkpad_x1_carbon-10,1526,31536
Lenovo ThinkPad X1 Carbon,809,58200,98100,87128,4,1,lenovo_thinkpad_x1_carbon-11,1527,10972
Lenovo ThinkPad X1 Carbon,575,51600,90900,78128,5,3,lenovo_thinkpad_x1_carbon-12,1528,12772
Lenovo ThinkPad X1 Carbon,71,57000,94500,77438,3,3,lenovo_thinkpad_x1_carbon-13,1529,17062
Lenovo ThinkPad X1 Carbon,175,58800,95400,80028,3,2,lenovo_thinkpad_x1_carbon-14,1530,15372
Lenovo ThinkPad X1 Carbon,78,57000,96300,84510,4,2,lenovo_thinkpad_x1_carbon-15,1531,11790
Lenovo ThinkPad X1 Carbon,171,52800,91800,63720,1,2,lenovo_thinkpad_x1_carbon-16,1532,28080
Lenovo ThinkPad X1 Carbon,130,54600,92700,70412,2,3,lenovo_thinkpad_x1_carbon-17,1533,22288
Lenovo ThinkPad X1 Carbon,733,52800,99900,65988,1,2,lenovo_thinkpad_x1_carbon-18,1534,33912
Lenovo ThinkPad X1 Carbon,36,59400,99900,74385,2,4,lenovo_thinkpad_x1_carbon-19,1535,25515
Lenovo ThinkPad X1 Carbon,236,57600,99900,69444,1,2,lenovo_thinkpad_x1_carbon-20,1536,30456
Lenovo ThinkPad X1 Carbon,163,55200,97200,64440,1,3,lenovo_thinkpad_x1_carbon-21,1537,32760
Lenovo ThinkPad X1 Carbon,703,58200,99000,78804,2,1,lenovo_thinkpad_x1_carbon-22,1538,20196
Lenovo ThinkPad X1 Carbon,870,58200,99000,86760,5,2,lenovo_thinkpad_x1_carbon-23,1539,12240
Lenovo ThinkPad X1 Carbon,401,56400,95400,76290,3,4,lenovo_thinkpad_x1_carbon-24,1540,19110
Lenovo ThinkPad X1 Carbon,418,59400,100800,84862,3,1,lenovo_thinkpad_x1_carbon-25,1541,15938
Lenovo ThinkPad X1 Carbon,146,58200,103500,81077,2,1,lenovo_thinkpad_x1_carbon-26,1542,22423
Lenovo ThinkPad X1 Carbon,582,51600,92700,78315,4,4,lenovo_thinkpad_x1_carbon-27,1543,14385
Lenovo ThinkPad X1 Carbon,257,51600,101700,82412,3,1,lenovo_thinkpad_x1_carbon-28,1544,19288
Microsoft Surface Laptop 4,506,66750,122625,84910,2,5,microsoft_surface_laptop_4-0,1545,37715
Microsoft Surface Laptop 4,592,73500,121500,104700,5,4,microsoft_surface_laptop_4-1,1546,16800
Microsoft Surface Laptop 4,651,67500,129375,107719,5,4,microsoft_surface_laptop_4-2,1547,21656
Microsoft Surface Laptop 4,893,71250,124875,93505,2,3,microsoft_surface_laptop_4-3,1548,31370
Microsoft Surface Laptop 4,575,67500,113625,96329,4,5,microsoft_surface_laptop_4-4,1549,17296
Microsoft Surface Laptop 4,716,68250,129375,106454,5,5,microsoft_surface_laptop_4-5,1550,22921
Microsoft Surface Laptop 4,455,72000,123750,80280,1,4,microsoft_surface_laptop_4-6,1551,43470
Microsoft Surface Laptop 4,920,72000,115875,94157,2,1,microsoft_surface_laptop_4-7,1552,21718
Microsoft Surface Laptop 4,627,64500,127125,109904,4,1,microsoft_surface_laptop_4-8,1553,17221
Microsoft Surface Laptop 4,28,71250,124875,107447,5,3,microsoft_surface_laptop_4-9,1554,17428
Microsoft Surface Laptop 4,669,66000,120375,104063,4,2,microsoft_surface_laptop_4-10,1555,16312
Microsoft Surface Laptop 4,175,67500,113625,98635,5,3,microsoft_surface_laptop_4-11,1556,14990
Microsoft Surface Laptop 4,371,63750,128250,101160,3,2,microsoft_surface_laptop_4-12,1557,27090
Microsoft Surface Laptop 4,356,67500,128250,104862,3,1,microsoft_surface_laptop_4-13,1558,23388
Microsoft Surface Laptop 4,113,72000,117000,102375,5,3,microsoft_surface_laptop_4-14,1559,14625
Microsoft Surface Laptop 4,798,67500,115875,98944,4,4,microsoft_surface_laptop_4-15,1560,16931
Microsoft Surface Laptop 4,193,68250,118125,79223,1,3,microsoft_surface_laptop_4-16,1561,38902
Microsoft Surface Laptop 4,622,72750,115875,79650,1,4,microsoft_surface_laptop_4-17,1562,36225
Microsoft Surface Laptop 4,184,66000,119250,99282,4,5,microsoft_surface_laptop_4-18,1563,19968
Microsoft Surface Laptop 4,431,64500,114750,98419,5,3,microsoft_surface_laptop_4-19,1564,16331
Microsoft Surface Laptop 4,439,72750,126000,98044,3,5,microsoft_surface_laptop_4-20,1565,27956
Microsoft Surface Laptop 4,870,74250,117000,86220,1,2,microsoft_surface_laptop_4-21,1566,30780
Microsoft Surface Laptop 4,92,66000,115875,93182,3,3,microsoft_surface_laptop_4-22,1567,22693
Asus ZenBook 14,871,57850,111150,69576,1,3,asus_zenbook_14-0,1568,41574
Asus ZenBook 14,88,55250,98475,67353,1,2,asus_zenbook_14-1,1569,31122
Asus ZenBook 14,722,57200,102375,81821,3,3,asus_zenbook_14-2,1570,20554
Asus ZenBook 14,685,62400,106275,93113,4,2,asus_zenbook_14-3,1571,13162
Asus ZenBook 14,875,57200,104325,67568,1,3,asus_zenbook_14-4,1572,36757
Asus ZenBook 14,754,55250,111150,75933,2,4,asus_zenbook_14-5,1573,35217
Asus ZenBook 14,301,55900,107250,73359,1,1,asus_zenbook_14-6,1574,33891
Asus ZenBook 14,144,61750,110175,93227,4,4,asus_zenbook_14-7,1575,16948
Asus ZenBook 14,456,64350,105300,89535,3,1,asus_zenbook_14-8,1576,15765
Asus ZenBook 14,376,62400,98475,75748,2,4,asus_zenbook_14-9,1577,22727
Asus ZenBook 14,878,63700,105300,92820,4,2,asus_zenbook_14-10,1578,12480
Asus ZenBook 14,800,60450,111150,97208,4,1,asus_zenbook_14-11,1579,13942
Asus ZenBook 14,891,60450,110175,83324,2,2,asus_zenbook_14-12,1580,26851
Asus ZenBook 14,495,55250,111150,94380,4,2,asus_zenbook_14-13,1581,16770
Asus ZenBook 14,121,58500,109200,86132,3,3,asus_zenbook_14-14,1582,23068
Asus ZenBook 14,531,58500,102375,73418,1,1,asus_zenbook_14-15,1583,28957
Asus ZenBook 14,615,62400,112125,89501,3,3,asus_zenbook_14-16,1584,22624
Asus ZenBook 14,151,59800,111150,68016,1,4,asus_zenbook_14-17,1585,43134
Asus ZenBook 14,167,59800,100425,85191,5,5,asus_zenbook_14-18,1586,15234
Asus ZenBook 14,981,59150,109200,94185,4,2,asus_zenbook_14-19,1587,15015
Asus ZenBook 14,735,64350,112125,94210,4,5,asus_zenbook_14-20,1588,17915
Asus ZenBook 14,695,61100,100425,65033,1,5,asus_zenbook_14-21,1589,35392
Asus ZenBook 14,984,56550,101400,71799,1,1,asus_zenbook_14-22,1590,29601
Asus ZenBook 14,289,60450,111150,95940,5,2,asus_zenbook_14-23,1591,15210
Asus ZenBook 14,322,64350,107250,91163,5,5,asus_zenbook_14-24,1592,16087
Asus ZenBook 14,972,55250,101400,78787,3,4,asus_zenbook_14-25,1593,22613
Asus ZenBook 14,524,62400,100425,70766,1,3,asus_zenbook_14-26,1594,29659
Acer Swift 3,321,46500,84750,60653,2,4,acer_swift_3-0,1595,24097
Acer Swift 3,517,43500,86250,47775,1,5,acer_swift_3-1,1596,38475
Acer Swift 3,985,43500,77250,67125,4,2,acer_swift_3-2,1597,10125
Acer Swift 3,101,44500,84750,55770,1,2,acer_swift_3-3,1598,28980
Acer Swift 3,202,49000,79500,69588,5,3,acer_swift_3-4,1599,9912
Acer Swift 3,484,47000,75750,60657,3,5,acer_swift_3-5,1600,15093
Acer Swift 3,406,49500,75750,66563,5,4,acer_swift_3-6,1601,9187
Acer Swift 3,166,45000,78750,56475,1,1,acer_swift_3-7,1602,22275
Acer Swift 3,578,44500,85500,65205,2,1,acer_swift_3-8,1603,20295
Acer Swift 3,750,49500,78000,63038,3,5,acer_swift_3-9,1604,14962
Acer Swift 3,373,44500,78750,66763,5,4,acer_swift_3-10,1605,11987
Acer Swift 3,721,43000,75750,65107,4,3,acer_swift_3-11,1606,10643
Acer Swift 3,140,45000,81750,68888,5,4,acer_swift_3-12,1607,12862
Acer Swift 3,155,49000,78000,55380,1,3,acer_swift_3-13,1608,22620
Acer Swift 3,513,45000,83250,71775,5,2,acer_swift_3-14,1609,11475
Acer Swift 3,256,43500,78750,59715,2,2,acer_swift_3-15,1610,19035
Acer Swift 3,28,47000,82500,58538,2,5,acer_swift_3-16,1611,23962
Acer Swift 3,311,45500,86250,74025,5,2,acer_swift_3-17,1612,12225
Acer Swift 3,285,49000,85500,65790,2,2,acer_swift_3-18,1613,19710
Acer Swift 3,184,48000,78000,59100,2,4,acer_swift_3-19,1614,18900
Razer Blade 15,510,114000,194400,164250,4,5,razer_blade_15-0,1615,30150
Razer Blade 15,348,116400,192600,165930,4,4,razer_blade_15-1,1616,26670
Razer Blade 15,38,112800,185400,165435,4,1,razer_blade_15-2,1617,19965
Razer Blade 15,595,110400,205200,149742,2,3,razer_blade_15-3,1618,55458
Razer Blade 15,84,103200,203400,135765,2,5,razer_blade_15-4,1619,67635
Razer Blade 15,41,111600,189000,165780,5,2,razer_blade_15-5,1620,23220
Razer Blade 15,494,103200,185400,162795,5,1,razer_blade_15-6,1621,22605
Razer Blade 15,946,114000,203400,133668,1,3,razer_blade_15-7,1622,69732
Razer Blade 15,454,118800,189000,164430,4,4,razer_blade_15-8,1623,24570
Razer Blade 15,718,103200,189000,161115,4,3,razer_blade_15-9,1624,27885
Razer Blade 15,453,115200,192600,167445,5,3,razer_blade_15-10,1625,25155
Razer Blade 15,906,115200,194400,140940,2,5,razer_blade_15-11,1626,53460
Razer Blade 15,167,117600,194400,134496,1,3,razer_blade_15-12,1627,59904
Razer Blade 15,32,116400,199800,167692,3,1,razer_blade_15-13,1628,32108
Razer Blade 15,347,111600,194400,165420,5,4,razer_blade_15-14,1629,28980
Razer Blade 15,97,104400,185400,151380,3,2,razer_blade_15-15,1630,34020
Razer Blade 15,983,109200,198000,151381,3,5,razer_blade_15-16,1631,46619
Razer Blade 15,828,111600,185400,138906,2,4,razer_blade_15-17,1632,46494
Razer Blade 15,629,104400,194400,165150,5,3,razer_blade_15-18,1633,29250
Razer Blade 15,808,116400,183600,163440,4,2,razer_blade_15-19,1634,20160
Razer Blade 15,156,108000,203400,123264,1,4,razer_blade_15-20,1635,80136
Lenovo Yoga C940,220,82800,151200,114264,2,2,lenovo_yoga_c940-0,1636,36936
Lenovo Yoga C940,941,77400,145800,123570,4,3,lenovo_yoga_c940-1,1637,22230
Lenovo Yoga C940,154,82800,144450,122873,5,4,lenovo_yoga_c940-2,1638,21577
Lenovo Yoga C940,266,78300,153900,133110,4,1,lenovo_yoga_c940-3,1639,20790
Lenovo Yoga C940,944,79200,151200,129600,5,2,lenovo_yoga_c940-4,1640,21600
Lenovo Yoga C940,95,84600,141750,108318,2,3,lenovo_yoga_c940-5,1641,33432
Lenovo Yoga C940,392,81900,147150,125944,5,3,lenovo_yoga_c940-6,1642,21206
Lenovo Yoga C940,979,78300,148500,119016,3,2,lenovo_yoga_c940-7,1643,29484
Lenovo Yoga C940,653,85500,153900,92340,1,5,lenovo_yoga_c940-8,1644,61560
Lenovo Yoga C940,748,86400,141750,112692,3,5,lenovo_yoga_c940-9,1645,29058
Lenovo Yoga C940,35,84600,136350,89775,1,5,lenovo_yoga_c940-10,1646,46575
Lenovo Yoga C940,144,76500,136350,96849,1,1,lenovo_yoga_c940-11,1647,39501
Lenovo Yoga C940,543,81900,151200,128678,5,3,lenovo_yoga_c940-12,1648,22522
Lenovo Yoga C940,384,85500,143100,116892,3,3,lenovo_yoga_c940-13,1649,26208
Lenovo Yoga C940,688,83700,145800,103883,2,5,lenovo_yoga_c940-14,1650,41917
Lenovo Yoga C940,601,77400,151200,130905,4,1,lenovo_yoga_c940-15,1651,20295
Lenovo Yoga C940,221,89100,153900,118908,2,2,lenovo_yoga_c940-16,1652,34992
Lenovo Yoga C940,468,81900,151200,126945,5,4,lenovo_yoga_c940-17,1653,24255
Lenovo Yoga C940,656,80100,148500,126270,4,3,lenovo_yoga_c940-18,1654,22230
Lenovo Yoga C940,977,81000,148500,115425,3,4,lenovo_yoga_c940-19,1655,33075
Lenovo Yoga C940,935,81000,137700,122108,5,1,lenovo_yoga_c940-20,1656,15592
Lenovo Yoga C940,190,86400,153900,108338,2,5,lenovo_yoga_c940-21,1657,45562
Lenovo Yoga C940,567,81000,151200,92232,1,4,lenovo_yoga_c940-22,1658,58968
Lenovo Yoga C940,460,86400,152550,120137,3,4,lenovo_yoga_c940-23,1659,32413
Lenovo Yoga C940,328,81900,144450,105044,2,4,lenovo_yoga_c940-24,1660,39406
Lenovo Yoga C940,382,82800,152550,128138,4,4,lenovo_yoga_c940-25,1661,24412
Lenovo Yoga C940,850,85500,140400,121185,5,4,lenovo_yoga_c940-26,1662,19215
HP Envy 13,409,55800,103500,89190,5,2,hp_envy_13-0,1663,14310
HP Envy 13,30,57000,95400,71208,2,4,hp_envy_13-1,1664,24192
HP Envy 13,778,58200,94500,71631,2,4,hp_envy_13-2,1665,22869
HP Envy 13,859,57600,101700,88470,4,2,hp_envy_13-3,1666,13230
HP Envy 13,573,54000,95400,69318,2,4,hp_envy_13-4,1667,26082
HP Envy 13,110,54600,97200,58860,1,5,hp_envy_13-5,1668,38340
HP Envy 13,906,57000,100800,79119,2,1,hp_envy_13-6,1669,21681
HP Envy 13,29,58800,100800,89250,4,1,hp_envy_13-7,1670,11550
HP Envy 13,711,57000,96300,78419,3,3,hp_envy_13-8,1671,17881
HP Envy 13,154,55200,90900,77156,3,1,hp_envy_13-9,1672,13744
HP Envy 13,157,52200,99900,56970,1,5,hp_envy_13-10,1673,42930
HP Envy 13,579,55200,95400,79923,3,1,hp_envy_13-11,1674,15477
HP Envy 13,444,55200,92700,81450,5,2,hp_envy_13-12,1675,11250
HP Envy 13,896,55800,100800,83925,4,5,hp_envy_13-13,1676,16875
HP Envy 13,152,58200,97200,83550,5,4,hp_envy_13-14,1677,13650
HP Envy 13,525,55800,98100,70182,1,1,hp_envy_13-15,1678,27918
HP Envy 13,612,51000,102600,88410,5,1,hp_envy_13-16,1679,14190
HP Envy 13,298,55800,96300,83138,4,3,hp_envy_13-17,1680,13162
HP Envy 13,948,58200,100800,84825,5,5,hp_envy_13-18,1681,15975
HP Envy 13,874,55200,94500,73868,3,5,hp_envy_13-19,1682,20632
HP Envy 13,145,51600,92700,71123,3,5,hp_envy_13-20,1683,21577
HP Envy 13,333,58800,100800,88200,5,2,hp_envy_13-21,1684,12600
HP Envy 13,161,51000,90900,75938,5,5,hp_envy_13-22,1685,14962
HP Envy 13,315,58800,94500,70938,1,1,hp_envy_13-23,1686,23562
HP Envy 13,27,54600,94500,72954,2,2,hp_envy_13-24,1687,21546
Dell Inspiron 15,422,37600,61800,45465,2,5,dell_inspiron_15-0,1688,16335
Dell Inspiron 15,406,37200,68400,54204,3,3,dell_inspiron_15-1,1689,14196
Dell Inspiron 15,149,36400,66000,55640,5,4,dell_inspiron_15-2,1690,10360
Dell Inspiron 15,433,35200,60600,53615,5,1,dell_inspiron_15-3,1691,6985
Dell Inspiron 15,248,35600,63000,54095,4,3,dell_inspiron_15-4,1692,8905
Dell Inspiron 15,58,34800,64800,48600,2,2,dell_inspiron_15-5,1693,16200
Dell Inspiron 15,250,38000,64800,40680,1,5,dell_inspiron_15-6,1694,24120
Dell Inspiron 15,473,37200,69000,50397,2,3,dell_inspiron_15-7,1695,18603
Dell Inspiron 15,419,37600,61200,41376,1,4,dell_inspiron_15-8,1696,19824
Dell Inspiron 15,858,38800,64200,55310,4,4,dell_inspiron_15-9,1697,8890
Dell Inspiron 15,974,34400,67800,51434,3,4,dell_inspiron_15-10,1698,16366
Dell Inspiron 15,953,39200,67200,58100,5,3,dell_inspiron_15-11,1699,9100
Dell Inspiron 15,651,37600,61200,49636,3,4,dell_inspiron_15-12,1700,11564
Dell Inspiron 15,432,38800,63600,56160,4,2,dell_inspiron_15-13,1701,7440
Dell Inspiron 15,240,38800,66000,53624,3,3,dell_inspiron_15-14,1702,12376
Dell Inspiron 15,454,36000,61200,53010,5,3,dell_inspiron_15-15,1703,8190
Dell Inspiron 15,310,37200,66000,55920,5,4,dell_inspiron_15-16,1704,10080
Dell Inspiron 15,700,39600,68400,59040,4,3,dell_inspiron_15-17,1705,9360
Dell Inspiron 15,977,39600,66000,52140,3,5,dell_inspiron_15-18,1706,13860
Dell Inspiron 15,909,34000,68400,55500,4,5,dell_inspiron_15-19,1707,12900
Dell Inspiron 15,361,34800,67200,52458,3,3,dell_inspiron_15-20,1708,14742
Dell Inspiron 15,243,36800,66600,56170,5,4,dell_inspiron_15-21,1709,10430
Dell Inspiron 15,735,39600,64800,57870,5,1,dell_inspiron_15-22,1710,6930
Dell Inspiron 15,700,38800,61200,43728,1,3,dell_inspiron_15-23,1711,17472
Dell Inspiron 15,398,35600,64800,46404,2,4,dell_inspiron_15-24,1712,18396
Dell Inspiron 15,661,35600,67200,38760,1,5,dell_inspiron_15-25,1713,28440
Dell Inspiron 15,36,37600,63600,54500,4,4,dell_inspiron_15-26,1714,9100
Apple MacBook Air (M1),833,68800,122400,104980,5,3,apple_macbook_air_m1-0,1715,17420
Apple MacBook Air (M1),725,78400,122400,90720,1,2,apple_macbook_air_m1-1,1716,31680
Apple MacBook Air (M1),569,72800,132000,85824,1,3,apple_macbook_air_m1-2,1717,46176
Apple MacBook Air (M1),424,79200,133200,104850,3,5,apple_macbook_air_m1-3,1718,28350
Apple MacBook Air (M1),90,70400,132000,110440,4,4,apple_macbook_air_m1-4,1719,21560
Apple MacBook Air (M1),383,68800,123600,91542,2,3,apple_macbook_air_m1-5,1720,32058
Apple MacBook Air (M1),76,71200,130800,95934,2,3,apple_macbook_air_m1-6,1721,34866
Apple MacBook Air (M1),736,68000,127200,88128,1,1,apple_macbook_air_m1-7,1722,39072
Apple MacBook Air (M1),326,75200,132000,114960,5,2,apple_macbook_air_m1-8,1723,17040
Apple MacBook Air (M1),175,68800,130800,112200,4,2,apple_macbook_air_m1-9,1724,18600
Apple MacBook Air (M1),354,76800,136800,90000,1,3,apple_macbook_air_m1-10,1725,46800
Apple MacBook Air (M1),578,77600,134400,113100,5,5,apple_macbook_air_m1-11,1726,21300
Apple MacBook Air (M1),224,76800,122400,99828,2,1,apple_macbook_air_m1-12,1727,22572
Apple MacBook Air (M1),438,79200,127200,95520,1,1,apple_macbook_air_m1-13,1728,31680
Apple MacBook Air (M1),568,68000,136800,110312,3,1,apple_macbook_air_m1-14,1729,26488
Apple MacBook Air (M1),983,71200,121200,94950,3,5,apple_macbook_air_m1-15,1730,26250
Apple MacBook Air (M1),494,74400,132000,116160,4,1,apple_macbook_air_m1-16,1731,15840
Apple MacBook Air (M1),49,72000,133200,100152,2,2,apple_macbook_air_m1-17,1732,33048
Apple MacBook Air (M1),294,77600,129600,104120,3,4,apple_macbook_air_m1-18,1733,25480
Apple MacBook Air (M1),69,69600,122400,102600,4,5,apple_macbook_air_m1-19,1734,19800
Apple MacBook Air (M1),902,75200,134400,91776,1,2,apple_macbook_air_m1-20,1735,42624
Apple MacBook Air (M1),765,76000,124800,104304,3,2,apple_macbook_air_m1-21,1736,20496
Apple MacBook Air (M1),839,73600,133200,116810,5,1,apple_macbook_air_m1-22,1737,16390
Apple MacBook Air (M1),369,76000,121200,106510,4,3,apple_macbook_air_m1-23,1738,14690
Apple MacBook Air (M1),810,70400,132000,115060,4,1,apple_macbook_air_m1-24,1739,16940
Microsoft Surface Pro 8,489,81000,141750,101655,1,1,microsoft_surface_pro_8-0,1740,40095
Microsoft Surface Pro 8,975,87300,141750,121332,4,5,microsoft_surface_pro_8-1,1741,20418
Microsoft Surface Pro 8,791,76500,143100,91152,1,3,microsoft_surface_pro_8-2,1742,51948
Microsoft Surface Pro 8,424,86400,143100,117302,3,3,microsoft_surface_pro_8-3,1743,25798
Microsoft Surface Pro 8,450,76500,149850,127845,5,2,microsoft_surface_pro_8-4,1744,22005
Microsoft Surface Pro 8,384,79200,153900,127755,4,4,microsoft_surface_pro_8-5,1745,26145
Microsoft Surface Pro 8,973,80100,140400,115074,3,2,microsoft_surface_pro_8-6,1746,25326
Microsoft Surface Pro 8,845,76500,147150,122423,4,4,microsoft_surface_pro_8-7,1747,24727
Microsoft Surface Pro 8,378,86400,151200,113292,2,3,microsoft_surface_pro_8-8,1748,37908
Microsoft Surface Pro 8,605,84600,147150,125258,4,4,microsoft_surface_pro_8-9,1749,21892
Microsoft Surface Pro 8,431,85500,136350,102027,2,5,microsoft_surface_pro_8-10,1750,34323
Microsoft Surface Pro 8,916,85500,147150,106461,1,1,microsoft_surface_pro_8-11,1751,40689
Microsoft Surface Pro 8,577,81000,141750,120488,4,4,microsoft_surface_pro_8-12,1752,21262
Microsoft Surface Pro 8,929,82800,155250,98739,1,3,microsoft_surface_pro_8-13,1753,56511
Microsoft Surface Pro 8,616,78300,149850,128385,4,2,microsoft_surface_pro_8-14,1754,21465
Microsoft Surface Pro 8,100,81000,153900,125834,3,1,microsoft_surface_pro_8-15,1755,28066
Microsoft Surface Pro 8,627,83700,147150,110032,2,3,microsoft_surface_pro_8-16,1756,37118
Microsoft Surface Pro 8,650,89100,137700,121905,4,3,microsoft_surface_pro_8-17,1757,15795
Microsoft Surface Pro 8,476,88200,155250,135135,4,2,microsoft_surface_pro_8-18,1758,20115
Microsoft Surface Pro 8,474,80100,148500,126270,5,3,microsoft_surface_pro_8-19,1759,22230
Microsoft Surface Pro 8,64,81000,152550,125004,3,1,microsoft_surface_pro_8-20,1760,27546
Microsoft Surface Pro 8,215,76500,139050,117158,5,4,microsoft_surface_pro_8-21,1761,21892
Microsoft Surface Pro 8,391,82800,144450,127497,5,1,microsoft_surface_pro_8-22,1762,16953
Microsoft Surface Pro 8,520,85500,144450,128239,5,1,microsoft_surface_pro_8-23,1763,16211
Asus ROG Zephyrus G14,738,135000,229500,198788,4,3,asus_rog_zephyrus_g14-0,1764,30712
Asus ROG Zephyrus G14,857,130500,234000,164138,2,5,asus_rog_zephyrus_g14-1,1765,69862
Asus ROG Zephyrus G14,375,139500,258750,165735,1,3,asus_rog_zephyrus_g14-2,1766,93015
Asus ROG Zephyrus G14,896,147000,247500,212325,4,4,asus_rog_zephyrus_g14-3,1767,35175
Asus ROG Zephyrus G14,446,130500,245250,193039,3,3,asus_rog_zephyrus_g14-4,1768,52211
Asus ROG Zephyrus G14,552,148500,234000,195098,3,3,asus_rog_zephyrus_g14-5,1769,38902
Asus ROG Zephyrus G14,700,130500,240750,204919,4,3,asus_rog_zephyrus_g14-6,1770,35831
Asus ROG Zephyrus G14,742,135000,227250,194963,4,4,asus_rog_zephyrus_g14-7,1771,32287
Asus ROG Zephyrus G14,228,138000,243000,176850,2,4,asus_rog_zephyrus_g14-8,1772,66150
Asus ROG Zephyrus G14,171,132000,231750,194344,5,5,asus_rog_zephyrus_g14-9,1773,37406
Asus ROG Zephyrus G14,200,139500,252000,176063,2,5,asus_rog_zephyrus_g14-10,1774,75937
Asus ROG Zephyrus G14,450,127500,231750,187965,3,2,asus_rog_zephyrus_g14-11,1775,43785
Asus ROG Zephyrus G14,335,148500,229500,201150,4,4,asus_rog_zephyrus_g14-12,1776,28350
Asus ROG Zephyrus G14,718,130500,229500,146340,1,4,asus_rog_zephyrus_g14-13,1777,83160
Asus ROG Zephyrus G14,800,127500,243000,159840,1,2,asus_rog_zephyrus_g14-14,1778,83160
Asus ROG Zephyrus G14,194,133500,236250,189499,3,3,asus_rog_zephyrus_g14-15,1779,46751
Asus ROG Zephyrus G14,904,145500,236250,194959,3,3,asus_rog_zephyrus_g14-16,1780,41291
Asus ROG Zephyrus G14,393,130500,249750,156735,1,3,asus_rog_zephyrus_g14-17,1781,93015
Asus ROG Zephyrus G14,54,136500,238500,158940,1,3,asus_rog_zephyrus_g14-18,1782,79560
Asus ROG Zephyrus G14,575,129000,247500,185288,3,5,asus_rog_zephyrus_g14-19,1783,62212
Asus ROG Zephyrus G14,373,130500,240750,181215,2,2,asus_rog_zephyrus_g14-20,1784,59535
Acer Predator Helios 300,674,111600,199800,165843,3,1,acer_predator_helios_300-0,1785,33957
Acer Predator Helios 300,170,115200,194400,151632,2,2,acer_predator_helios_300-1,1786,42768
Acer Predator Helios 300,481,104400,196200,142497,2,3,acer_predator_helios_300-2,1787,53703
Acer Predator Helios 300,922,109200,201600,173880,4,2,acer_predator_helios_300-3,1788,27720
Acer Predator Helios 300,317,106800,203400,176835,5,1,acer_predator_helios_300-4,1789,26565
Acer Predator Helios 300,836,105600,185400,149091,3,3,acer_predator_helios_300-5,1790,36309
Acer Predator Helios 300,953,118800,185400,165420,5,2,acer_predator_helios_300-6,1791,19980
Acer Predator Helios 300,383,105600,199800,120672,1,4,acer_predator_helios_300-7,1792,79128
Acer Predator Helios 300,582,102000,199800,172905,5,1,acer_predator_helios_300-8,1793,26895
Acer Predator Helios 300,660,106800,185400,161820,4,2,acer_predator_helios_300-9,1794,23580
Acer Predator Helios 300,363,117600,203400,160929,2,1,acer_predator_helios_300-10,1795,42471
Acer Predator Helios 300,778,106800,196200,167145,4,3,acer_predator_helios_300-11,1796,29055
Acer Predator Helios 300,200,112800,205200,179790,5,1,acer_predator_helios_300-12,1797,25410
Acer Predator Helios 300,455,102000,201600,164250,5,5,acer_predator_helios_300-13,1798,37350
Acer Predator Helios 300,398,109200,187200,157950,5,5,acer_predator_helios_300-14,1799,29250
Acer Predator Helios 300,928,111600,190800,161100,4,5,acer_predator_helios_300-15,1800,29700
Acer Predator Helios 300,811,104400,205200,169920,4,4,acer_predator_helios_300-16,1801,35280
Acer Predator Helios 300,326,114000,189000,152250,3,4,acer_predator_helios_300-17,1802,36750
Acer Predator Helios 300,175,116400,181800,149427,2,1,acer_predator_helios_300-18,1803,32373
Acer Predator Helios 300,893,118800,196200,172980,4,2,acer_predator_helios_300-19,1804,23220
Acer Predator Helios 300,438,117600,183600,158850,5,5,acer_predator_helios_300-20,1805,24750
Acer Predator Helios 300,52,108000,189000,160650,4,4,acer_predator_helios_300-21,1806,28350
Acer Predator Helios 300,395,110400,181800,158595,5,3,acer_predator_helios_300-22,1807,23205
Acer Predator Helios 300,602,108000,190800,165960,4,2,acer_predator_helios_300-23,1808,24840
Acer Predator Helios 300,380,110400,201600,144144,2,4,acer_predator_helios_300-24,1809,57456
Acer Predator Helios 300,249,110400,198000,134928,1,2,acer_predator_helios_300-25,1810,63072
Acer Predator Helios 300,590,104400,181800,156645,4,3,acer_predator_helios_300-26,1811,25155
Acer Predator Helios 300,241,112800,187200,164880,5,2,acer_predator_helios_300-27,1812,22320
Acer Predator Helios 300,168,102000,190800,166380,5,1,acer_predator_helios_300-28,1813,24420
HP Pavilion 15,583,44500,78750,68475,4,2,hp_pavilion_15-0,1814,10275
HP Pavilion 15,483,46000,80250,67407,5,5,hp_pavilion_15-1,1815,12843
HP Pavilion 15,790,45500,80250,66872,3,1,hp_pavilion_15-2,1816,13378
HP Pavilion 15,985,44500,85500,51060,1,4,hp_pavilion_15-3,1817,34440
HP Pavilion 15,827,42500,83250,51465,1,3,hp_pavilion_15-4,1818,31785
HP Pavilion 15,387,46500,75750,51180,1,4,hp_pavilion_15-5,1819,24570
HP Pavilion 15,578,47000,82500,54810,1,3,hp_pavilion_15-6,1820,27690
HP Pavilion 15,492,49500,86250,75225,4,2,hp_pavilion_15-7,1821,11025
HP Pavilion 15,292,48500,85500,60525,2,5,hp_pavilion_15-8,1822,24975
HP Pavilion 15,597,49500,78000,64035,3,4,hp_pavilion_15-9,1823,13965
HP Pavilion 15,805,45000,80250,62802,2,1,hp_pavilion_15-10,1824,17448
HP Pavilion 15,725,46500,78000,63668,3,3,hp_pavilion_15-11,1825,14332
HP Pavilion 15,214,43500,77250,67125,5,2,hp_pavilion_15-12,1826,10125
HP Pavilion 15,856,47000,79500,60488,2,3,hp_pavilion_15-13,1827,19012
HP Pavilion 15,706,43500,76500,62640,3,2,hp_pavilion_15-14,1828,13860
HP Pavilion 15,753,49000,76500,59175,2,4,hp_pavilion_15-15,1829,17325
HP Pavilion 15,427,46000,86250,75182,5,1,hp_pavilion_15-16,1830,11068
HP Pavilion 15,69,45500,77250,60105,2,2,hp_pavilion_15-17,1831,17145
HP Pavilion 15,231,45000,76500,67838,5,1,hp_pavilion_15-18,1832,8662
HP Pavilion 15,237,48000,75750,52440,1,4,hp_pavilion_15-19,1833,23310
HP Pavilion 15,783,48500,76500,66700,4,4,hp_pavilion_15-20,1834,9800
HP Pavilion 15,208,46500,84000,70875,4,4,hp_pavilion_15-21,1835,13125
HP Pavilion 15,693,46000,80250,69119,5,3,hp_pavilion_15-22,1836,11131
HP Pavilion 15,345,46500,78000,57210,1,1,hp_pavilion_15-23,1837,20790
HP Pavilion 15,682,44000,80250,62307,2,1,hp_pavilion_15-24,1838,17943
Lenovo Legion 5,351,91000,165000,139100,4,4,lenovo_legion_5-0,1839,25900
Lenovo Legion 5,290,91000,153000,113940,2,4,lenovo_legion_5-1,1840,39060
Lenovo Legion 5,536,95000,166500,143263,4,3,lenovo_legion_5-2,1841,23237
Lenovo Legion 5,608,91000,156000,120900,2,2,lenovo_legion_5-3,1842,35100
Lenovo Legion 5,758,88000,163500,123863,3,5,lenovo_legion_5-4,1843,39637
Lenovo Legion 5,174,97000,168000,141375,4,5,lenovo_legion_5-5,1844,26625
Lenovo Legion 5,323,86000,157500,106020,1,2,lenovo_legion_5-6,1845,51480
Lenovo Legion 5,842,98000,163500,128130,2,2,lenovo_legion_5-7,1846,35370
Lenovo Legion 5,197,97000,151500,133788,4,3,lenovo_legion_5-8,1847,17712
Lenovo Legion 5,920,87000,157500,131063,5,5,lenovo_legion_5-9,1848,26437
Lenovo Legion 5,667,95000,159000,136600,4,4,lenovo_legion_5-10,1849,22400
Lenovo Legion 5,923,92000,168000,113280,1,2,lenovo_legion_5-11,1850,54720
Lenovo Legion 5,454,93000,151500,102360,1,4,lenovo_legion_5-12,1851,49140
Lenovo Legion 5,487,88000,168000,124800,2,2,lenovo_legion_5-13,1852,43200
Lenovo Legion 5,932,94000,171000,145975,5,3,lenovo_legion_5-14,1853,25025
Lenovo Legion 5,133,89000,153000,121640,3,4,lenovo_legion_5-15,1854,31360
Lenovo Legion 5,135,98000,154500,130770,3,2,lenovo_legion_5-16,1855,23730
Lenovo Legion 5,669,86000,159000,109725,2,5,lenovo_legion_5-17,1856,49275
Lenovo Legion 5,545,94000,153000,121140,2,2,lenovo_legion_5-18,1857,31860
Lenovo Legion 5,997,92000,171000,114120,1,2,lenovo_legion_5-19,1858,56880
Lenovo Legion 5,899,85000,154500,104460,1,2,lenovo_legion_5-20,1859,50040
Lenovo Legion 5,391,86000,159000,113010,2,4,lenovo_legion_5-21,1860,45990
Dell Latitude 14,239,64400,107100,78918,1,1,dell_latitude_14-0,1861,28182
Dell Latitude 14,214,67200,112350,85938,2,3,dell_latitude_14-1,1862,26412
Dell Latitude 14,164,66500,115500,98350,4,4,dell_latitude_14-2,1863,17150
Dell Latitude 14,993,60200,117600,95501,3,1,dell_latitude_14-3,1864,22099
Dell Latitude 14,406,66500,108150,93573,5,4,dell_latitude_14-4,1865,14577
Dell Latitude 14,933,67900,115500,72660,1,5,dell_latitude_14-5,1866,42840
Dell Latitude 14,668,60900,119700,90888,3,4,dell_latitude_14-6,1867,28812
Dell Latitude 14,89,62300,115500,93156,3,2,dell_latitude_14-7,1868,22344
Dell Latitude 14,718,62300,108150,77889,1,1,dell_latitude_14-8,1869,30261
Dell Latitude 14,738,62300,111300,96600,5,2,dell_latitude_14-9,1870,14700
Dell Latitude 14,686,63000,119700,99855,4,4,dell_latitude_14-10,1871,19845
Dell Latitude 14,294,65100,107100,95550,5,1,dell_latitude_14-11,1872,11550
Dell Latitude 14,977,67200,119700,91350,2,2,dell_latitude_14-12,1873,28350
Dell Latitude 14,22,60900,114450,88211,3,4,dell_latitude_14-13,1874,26239
Dell Latitude 14,788,69300,111300,73500,1,5,dell_latitude_14-14,1875,37800
Dell Latitude 14,128,65100,113400,82971,2,4,dell_latitude_14-15,1876,30429
Dell Latitude 14,171,64400,115500,83307,2,4,dell_latitude_14-16,1877,32193
Dell Latitude 14,251,61600,110250,84709,3,5,dell_latitude_14-17,1878,25541
Dell Latitude 14,524,61600,113400,99155,5,1,dell_latitude_14-18,1879,14245
Dell Latitude 14,398,60900,118650,101325,4,2,dell_latitude_14-19,1880,17325
Dell Latitude 14,498,67200,119700,99488,3,1,dell_latitude_14-20,1881,20212
Dell Latitude 14,24,60200,113400,93450,4,5,dell_latitude_14-21,1882,19950
Dell Latitude 14,906,63700,109200,76440,1,2,dell_latitude_14-22,1883,32760
Dell Latitude 14,899,66500,119700,91770,3,5,dell_latitude_14-23,1884,27930
Dell Latitude 14,553,60900,110250,91744,4,5,dell_latitude_14-24,1885,18506
Dell Latitude 14,331,69300,112350,87166,2,3,dell_latitude_14-25,1886,25184
Dell Latitude 14,628,65800,112350,97222,4,3,dell_latitude_14-26,1887,15128
Dell Latitude 14,733,67900,119700,100275,5,5,dell_latitude_14-27,1888,19425
Dell Latitude 14,52,63000,109200,84252,2,2,dell_latitude_14-28,1889,24948
Samsung Galaxy Book Pro,262,86400,141750,125145,5,2,samsung_galaxy_book_pro-0,1890,16605
Samsung Galaxy Book Pro,848,83700,137700,117450,4,5,samsung_galaxy_book_pro-1,1891,20250
Samsung Galaxy Book Pro,31,85500,145800,124695,5,4,samsung_galaxy_book_pro-2,1892,21105
Samsung Galaxy Book Pro,737,81000,147150,122344,4,5,samsung_galaxy_book_pro-3,1893,24806
Samsung Galaxy Book Pro,773,82800,155250,128082,4,5,samsung_galaxy_book_pro-4,1894,27168
Samsung Galaxy Book Pro,29,89100,148500,132165,4,1,samsung_galaxy_book_pro-5,1895,16335
Samsung Galaxy Book Pro,499,82800,140400,109296,2,2,samsung_galaxy_book_pro-6,1896,31104
Samsung Galaxy Book Pro,271,79200,153900,129623,5,3,samsung_galaxy_book_pro-7,1897,24277
Samsung Galaxy Book Pro,299,88200,147150,130939,5,1,samsung_galaxy_book_pro-8,1898,16211
Samsung Galaxy Book Pro,926,80100,148500,103356,1,1,samsung_galaxy_book_pro-9,1899,45144
Samsung Galaxy Book Pro,725,85500,145800,127710,5,2,samsung_galaxy_book_pro-10,1900,18090
Samsung Galaxy Book Pro,35,81000,147150,127305,5,2,samsung_galaxy_book_pro-11,1901,19845
Samsung Galaxy Book Pro,203,89100,139050,122817,5,3,samsung_galaxy_book_pro-12,1902,16233
Samsung Galaxy Book Pro,291,86400,144450,95688,1,4,samsung_galaxy_book_pro-13,1903,48762
Samsung Galaxy Book Pro,359,77400,140400,118350,5,4,samsung_galaxy_book_pro-14,1904,22050
Samsung Galaxy Book Pro,223,79200,152550,124311,3,1,samsung_galaxy_book_pro-15,1905,28239
Samsung Galaxy Book Pro,234,82800,144450,102837,2,5,samsung_galaxy_book_pro-16,1906,41613
Samsung Galaxy Book Pro,560,87300,136350,95148,1,4,samsung_galaxy_book_pro-17,1907,41202
Samsung Galaxy Book Pro,999,84600,145800,90720,1,5,samsung_galaxy_book_pro-18,1908,55080
Samsung Galaxy Book Pro,695,76500,148500,100980,1,1,samsung_galaxy_book_pro-19,1909,47520
Samsung Galaxy Book Pro,488,80100,155250,101142,1,2,samsung_galaxy_book_pro-20,1910,54108
Samsung Galaxy Book Pro,448,81900,152550,131355,5,2,samsung_galaxy_book_pro-21,1911,21195
Samsung Galaxy Book Pro,552,81000,144450,127002,5,1,samsung_galaxy_book_pro-22,1912,17448
Samsung Galaxy Book Pro,816,78300,139050,91665,1,3,samsung_galaxy_book_pro-23,1913,47385
Samsung Galaxy Book Pro,692,81900,149850,107042,2,4,samsung_galaxy_book_pro-24,1914,42808
Samsung Galaxy Book Pro,269,85500,155250,92475,1,5,samsung_galaxy_book_pro-25,1915,62775
Samsung Galaxy Book Pro,48,81000,144450,107332,2,3,samsung_galaxy_book_pro-26,1916,37118
Samsung Galaxy Book Pro,107,89100,152550,133515,5,2,samsung_galaxy_book_pro-27,1917,19035
Google Pixelbook Go,166,52200,91800,78930,4,3,google_pixelbook_go-0,1918,12870
Google Pixelbook Go,288,55200,93600,72864,2,2,google_pixelbook_go-1,1919,20736
Google Pixelbook Go,417,58800,92700,82530,4,2,google_pixelbook_go-2,1920,10170
Google Pixelbook Go,479,59400,95400,85500,4,1,google_pixelbook_go-3,1921,9900
Google Pixelbook Go,891,57600,92700,69008,2,5,google_pixelbook_go-4,1922,23692
Google Pixelbook Go,728,58800,101700,76604,2,3,google_pixelbook_go-5,1923,25096
Google Pixelbook Go,218,58800,92700,82530,4,2,google_pixelbook_go-6,1924,10170
Google Pixelbook Go,860,58800,100800,85050,4,5,google_pixelbook_go-7,1925,15750
Google Pixelbook Go,512,57600,103500,86288,5,5,google_pixelbook_go-8,1926,17212
Google Pixelbook Go,304,51600,94500,71978,3,5,google_pixelbook_go-9,1927,22522
Google Pixelbook Go,983,51600,97200,61632,1,3,google_pixelbook_go-10,1928,35568
Google Pixelbook Go,733,55200,96300,77600,3,3,google_pixelbook_go-11,1929,18700
Google Pixelbook Go,718,55800,101700,82422,3,2,google_pixelbook_go-12,1930,19278
Google Pixelbook Go,538,58200,92700,67860,1,2,google_pixelbook_go-13,1931,24840
Google Pixelbook Go,523,55200,93600,74592,2,1,google_pixelbook_go-14,1932,19008
Google Pixelbook Go,281,54600,102600,76680,2,2,google_pixelbook_go-15,1933,25920
Google Pixelbook Go,643,51000,99900,67626,1,1,google_pixelbook_go-16,1934,32274
Google Pixelbook Go,863,58800,93600,80550,5,5,google_pixelbook_go-17,1935,13050
Google Pixelbook Go,243,54000,97200,58320,1,5,google_pixelbook_go-18,1936,38880
Google Pixelbook Go,615,59400,94500,69228,1,2,google_pixelbook_go-19,1937,25272
Google Pixelbook Go,450,52200,90900,76388,4,5,google_pixelbook_go-20,1938,14512
Google Pixelbook Go,893,51600,96300,79091,3,1,google_pixelbook_go-21,1939,17209
Google Pixelbook Go,627,58200,103500,89910,5,2,google_pixelbook_go-22,1940,13590
Google Pixelbook Go,251,53400,91800,78360,5,4,google_pixelbook_go-23,1941,13440
Google Pixelbook Go,367,58800,95400,76185,3,5,google_pixelbook_go-24,1942,19215
Google Pixelbook Go,772,59400,103500,90270,5,2,google_pixelbook_go-25,1943,13230
Google Pixelbook Go,33,55200,95400,79923,3,1,google_pixelbook_go-26,1944,15477
Google Pixelbook Go,246,53400,100800,70938,2,4,google_pixelbook_go-27,1945,29862
Google Pixelbook Go,591,52200,92700,65970,1,1,google_pixelbook_go-28,1946,26730
iPhone 13,121,70400,128400,111000,5,2,iphone_13-0,1947,17400
iPhone 13,728,75200,124800,98760,3,5,iphone_13-1,1948,26040
iPhone 13,339,73600,127200,112460,5,1,iphone_13-2,1949,14740
iPhone 13,415,77600,130800,113510,4,3,iphone_13-3,1950,17290
iPhone 13,427,79200,133200,117000,5,2,iphone_13-4,1951,16200
iPhone 13,807,76000,128400,108750,4,5,iphone_13-5,1952,19650
iPhone 13,195,75200,126000,89424,1,2,iphone_13-6,1953,36576
iPhone 13,268,76800,132000,114060,4,3,iphone_13-7,1954,17940
iPhone 13,964,72800,132000,105064,3,3,iphone_13-8,1955,26936
iPhone 13,569,68000,135600,104842,3,3,iphone_13-9,1956,30758
iPhone 13,22,75200,127200,110300,5,3,iphone_13-10,1957,16900
iPhone 13,658,76800,127200,93936,1,1,iphone_13-11,1958,33264
iPhone 13,548,68800,121200,104170,4,3,iphone_13-12,1959,17030
iPhone 13,127,71200,130800,98616,2,2,iphone_13-13,1960,32184
iPhone 13,966,74400,126000,110520,4,2,iphone_13-14,1961,15480
iPhone 13,254,69600,122400,102072,3,1,iphone_13-15,1962,20328
iPhone 13,506,72000,127200,87456,1,2,iphone_13-16,1963,39744
iPhone 13,357,76000,130800,103674,2,1,iphone_13-17,1964,27126
iPhone 13,881,76000,135600,113250,4,5,iphone_13-18,1965,22350
iPhone 13,878,73600,132000,105428,3,3,iphone_13-19,1966,26572
Samsung Galaxy S21 Ultra,579,88200,148500,128903,4,3,samsung_galaxy_s21_ultra-0,1967,19597
Samsung Galaxy S21 Ultra,590,85500,136350,119824,5,3,samsung_galaxy_s21_ultra-1,1968,16526
Samsung Galaxy S21 Ultra,285,76500,153900,84240,1,5,samsung_galaxy_s21_ultra-2,1969,69660
Samsung Galaxy S21 Ultra,97,84600,155250,108621,1,1,samsung_galaxy_s21_ultra-3,1970,46629
Samsung Galaxy S21 Ultra,539,86400,145800,118773,3,3,samsung_galaxy_s21_ultra-4,1971,27027
Samsung Galaxy S21 Ultra,196,87300,141750,118881,3,2,samsung_galaxy_s21_ultra-5,1972,22869
Samsung Galaxy S21 Ultra,806,82800,141750,112570,2,1,samsung_galaxy_s21_ultra-6,1973,29180
Samsung Galaxy S21 Ultra,741,77400,140400,123075,4,1,samsung_galaxy_s21_ultra-7,1974,17325
Samsung Galaxy S21 Ultra,903,80100,153900,107406,2,4,samsung_galaxy_s21_ultra-8,1975,46494
Samsung Galaxy S21 Ultra,547,84600,143100,103613,2,5,samsung_galaxy_s21_ultra-9,1976,39487
Samsung Galaxy S21 Ultra,128,81000,144450,107332,2,3,samsung_galaxy_s21_ultra-10,1977,37118
Samsung Galaxy S21 Ultra,266,87300,145800,107190,1,1,samsung_galaxy_s21_ultra-11,1978,38610
Samsung Galaxy S21 Ultra,549,86400,155250,136317,4,1,samsung_galaxy_s21_ultra-12,1979,18933
Samsung Galaxy S21 Ultra,408,81900,143100,126270,4,1,samsung_galaxy_s21_ultra-13,1980,16830
Samsung Galaxy S21 Ultra,373,86400,137700,122310,5,2,samsung_galaxy_s21_ultra-14,1981,15390
Samsung Galaxy S21 Ultra,461,80100,148500,122850,5,5,samsung_galaxy_s21_ultra-15,1982,25650
Samsung Galaxy S21 Ultra,411,84600,145800,122850,5,5,samsung_galaxy_s21_ultra-16,1983,22950
Samsung Galaxy S21 Ultra,742,86400,145800,113724,2,2,samsung_galaxy_s21_ultra-17,1984,32076
Samsung Galaxy S21 Ultra,69,78300,139050,108979,2,1,samsung_galaxy_s21_ultra-18,1985,30071
Samsung Galaxy S21 Ultra,784,89100,139050,118071,3,2,samsung_galaxy_s21_ultra-19,1986,20979
Samsung Galaxy S21 Ultra,852,89100,144450,126462,5,3,samsung_galaxy_s21_ultra-20,1987,17988
Samsung Galaxy S21 Ultra,248,83700,144450,124707,4,3,samsung_galaxy_s21_ultra-21,1988,19743
Samsung Galaxy S21 Ultra,26,82800,141750,122592,4,3,samsung_galaxy_s21_ultra-22,1989,19158
Samsung Galaxy S21 Ultra,497,78300,148500,122175,5,5,samsung_galaxy_s21_ultra-23,1990,26325
Samsung Galaxy S21 Ultra,220,83700,144450,123188,5,4,samsung_galaxy_s21_ultra-24,1991,21262
Samsung Galaxy S21 Ultra,364,79200,137700,106988,3,5,samsung_galaxy_s21_ultra-25,1992,30712
Samsung Galaxy S21 Ultra,805,87300,141750,116976,3,3,samsung_galaxy_s21_ultra-26,1993,24774
Samsung Galaxy S21 Ultra,889,84600,152550,132165,4,2,samsung_galaxy_s21_ultra-27,1994,20385
Samsung Galaxy S21 Ultra,915,86400,152550,129398,5,4,samsung_galaxy_s21_ultra-28,1995,23152
Samsung Galaxy S21 Ultra,400,85500,144450,104659,2,5,samsung_galaxy_s21_ultra-29,1996,39791
Google Pixel 6 Pro,627,75650,141525,108917,2,1,google_pixel_6_pro-0,1997,32608
Google Pixel 6 Pro,656,79050,132600,98864,2,4,google_pixel_6_pro-1,1998,33736
Google Pixel 6 Pro,298,74800,130050,83640,1,4,google_pixel_6_pro-2,1999,46410
Google Pixel 6 Pro,873,80750,128775,102842,2,2,google_pixel_6_pro-3,2000,25933
Google Pixel 6 Pro,135,76500,146625,122082,5,4,google_pixel_6_pro-4,2001,24543
Google Pixel 6 Pro,814,79900,136425,92336,1,3,google_pixel_6_pro-5,2002,44089
Google Pixel 6 Pro,341,77350,135150,101337,2,3,google_pixel_6_pro-6,2003,33813
Google Pixel 6 Pro,339,84150,144075,93738,1,4,google_pixel_6_pro-7,2004,50337
Google Pixel 6 Pro,360,79900,137700,96084,1,2,google_pixel_6_pro-8,2005,41616
Google Pixel 6 Pro,627,77350,142800,121529,4,3,google_pixel_6_pro-9,2006,21271
Google Pixel 6 Pro,257,72250,130050,112710,4,2,google_pixel_6_pro-10,2007,17340
Google Pixel 6 Pro,791,81600,133875,99374,1,1,google_pixel_6_pro-11,2008,34501
Google Pixel 6 Pro,50,82450,142800,102969,1,1,google_pixel_6_pro-12,2009,39831
Google Pixel 6 Pro,620,73100,131325,110947,5,4,google_pixel_6_pro-13,2010,20378
Google Pixel 6 Pro,679,75650,141525,98048,1,1,google_pixel_6_pro-14,2011,43477
Google Pixel 6 Pro,819,77350,138975,120488,5,2,google_pixel_6_pro-15,2012,18487
Google Pixel 6 Pro,654,74800,144075,110131,3,4,google_pixel_6_pro-16,2013,33944
Google Pixel 6 Pro,321,73950,131325,114113,5,2,google_pixel_6_pro-17,2014,17212
Google Pixel 6 Pro,239,73100,142800,105162,2,2,google_pixel_6_pro-18,2015,37638
Google Pixel 6 Pro,121,77350,135150,104805,3,5,google_pixel_6_pro-19,2016,30345
Google Pixel 6 Pro,493,73100,133875,114124,4,3,google_pixel_6_pro-20,2017,19751
Google Pixel 6 Pro,226,83300,141525,125514,4,1,google_pixel_6_pro-21,2018,16011
Google Pixel 6 Pro,876,75650,133875,109421,3,2,google_pixel_6_pro-22,2019,24454
Google Pixel 6 Pro,189,76500,136425,109160,3,3,google_pixel_6_pro-23,2020,27265
Google Pixel 6 Pro,488,84150,145350,126990,4,2,google_pixel_6_pro-24,2021,18360
Google Pixel 6 Pro,260,82450,128775,112562,5,4,google_pixel_6_pro-25,2022,16213
Google Pixel 6 Pro,172,75650,135150,94988,2,5,google_pixel_6_pro-26,2023,40162
Google Pixel 6 Pro,759,83300,137700,111044,3,4,google_pixel_6_pro-27,2024,26656
OnePlus 9 Pro,122,76800,138000,116580,4,4,oneplus_9_pro-0,2025,21420
OnePlus 9 Pro,350,68800,134400,104552,3,3,oneplus_9_pro-1,2026,29848
OnePlus 9 Pro,268,72800,124800,106600,4,4,oneplus_9_pro-2,2027,18200
OnePlus 9 Pro,980,69600,133200,95994,2,3,oneplus_9_pro-3,2028,37206
OnePlus 9 Pro,327,76800,129600,115080,4,1,oneplus_9_pro-4,2029,14520
OnePlus 9 Pro,844,68800,123600,108530,4,1,oneplus_9_pro-5,2030,15070
OnePlus 9 Pro,739,72800,124800,105300,4,5,oneplus_9_pro-6,2031,19500
OnePlus 9 Pro,280,79200,126000,111960,4,2,oneplus_9_pro-7,2032,14040
OnePlus 9 Pro,545,68800,135600,87504,1,2,oneplus_9_pro-8,2033,48096
OnePlus 9 Pro,938,68800,123600,104420,5,4,oneplus_9_pro-9,2034,19180
OnePlus 9 Pro,556,72000,138000,102360,2,2,oneplus_9_pro-10,2035,35640
OnePlus 9 Pro,516,72800,127200,98640,3,5,oneplus_9_pro-11,2036,28560
OnePlus 9 Pro,797,78400,124800,112040,4,1,oneplus_9_pro-12,2037,12760
OnePlus 9 Pro,642,76000,135600,114740,4,4,oneplus_9_pro-13,2038,20860
OnePlus 9 Pro,618,69600,138000,94908,2,4,oneplus_9_pro-14,2039,43092
OnePlus 9 Pro,727,68800,130800,112200,4,2,oneplus_9_pro-15,2040,18600
OnePlus 9 Pro,722,72000,122400,102996,3,1,oneplus_9_pro-16,2041,19404
OnePlus 9 Pro,47,76000,124800,83808,1,4,oneplus_9_pro-17,2042,40992
OnePlus 9 Pro,239,69600,136800,111600,4,5,oneplus_9_pro-18,2043,25200
OnePlus 9 Pro,410,79200,136800,116640,4,4,oneplus_9_pro-19,2044,20160
OnePlus 9 Pro,317,71200,124800,98268,2,1,oneplus_9_pro-20,2045,26532
OnePlus 9 Pro,206,76800,127200,113340,5,1,oneplus_9_pro-21,2046,13860
OnePlus 9 Pro,681,75200,128400,109780,5,4,oneplus_9_pro-22,2047,18620
OnePlus 9 Pro,671,75200,124800,80160,1,5,oneplus_9_pro-23,2048,44640
OnePlus 9 Pro,103,70400,128400,97080,2,2,oneplus_9_pro-24,2049,31320
OnePlus 9 Pro,515,76800,133200,85824,1,4,oneplus_9_pro-25,2050,47376
OnePlus 9 Pro,90,76800,129600,93960,2,5,oneplus_9_pro-26,2051,35640
OnePlus 9 Pro,714,73600,124800,101504,3,3,oneplus_9_pro-27,2052,23296
OnePlus 9 Pro,699,73600,127200,104688,3,2,oneplus_9_pro-28,2053,22512
OnePlus 9 Pro,747,79200,130800,115320,5,2,oneplus_9_pro-29,2054,15480
Xiaomi Mi 11,586,59500,112350,95174,5,3,xiaomi_mi_11-0,2055,17176
Xiaomi Mi 11,262,61600,120750,67515,1,5,xiaomi_mi_11-1,2056,53235
Xiaomi Mi 11,613,64400,108150,82557,2,3,xiaomi_mi_11-2,2057,25593
Xiaomi Mi 11,433,60200,112350,84189,2,2,xiaomi_mi_11-3,2058,28161
Xiaomi Mi 11,107,66500,110250,73500,1,4,xiaomi_mi_11-4,2059,36750
Xiaomi Mi 11,899,62300,108150,66885,1,5,xiaomi_mi_11-5,2060,41265
Xiaomi Mi 11,266,61600,109200,77784,1,1,xiaomi_mi_11-6,2061,31416
Xiaomi Mi 11,192,68600,107100,88043,2,1,xiaomi_mi_11-7,2062,19057
Xiaomi Mi 11,28,59500,111300,85918,3,4,xiaomi_mi_11-8,2063,25382
Xiaomi Mi 11,559,61600,111300,82226,2,3,xiaomi_mi_11-9,2064,29074
Xiaomi Mi 11,772,68600,106050,81333,1,1,xiaomi_mi_11-10,2065,24717
Xiaomi Mi 11,784,61600,117600,99400,5,3,xiaomi_mi_11-11,2066,18200
Xiaomi Mi 11,383,66500,115500,100800,5,2,xiaomi_mi_11-12,2067,14700
Xiaomi Mi 11,429,65800,119700,71190,1,5,xiaomi_mi_11-13,2068,48510
Xiaomi Mi 11,591,60900,117600,97755,4,4,xiaomi_mi_11-14,2069,19845
Xiaomi Mi 11,603,63700,110250,93958,5,4,xiaomi_mi_11-15,2070,16292
Xiaomi Mi 11,236,69300,111300,96600,5,4,xiaomi_mi_11-16,2071,14700
Xiaomi Mi 11,629,69300,112350,81354,1,2,xiaomi_mi_11-17,2072,30996
Xiaomi Mi 11,311,59500,116550,96583,5,4,xiaomi_mi_11-18,2073,19967
Xiaomi Mi 11,352,63000,106050,92059,5,3,xiaomi_mi_11-19,2074,13991
Xiaomi Mi 11,85,65800,109200,81858,2,4,xiaomi_mi_11-20,2075,27342
Xiaomi Mi 11,30,65800,110250,72912,1,4,xiaomi_mi_11-21,2076,37338
Xiaomi Mi 11,930,60900,108150,65625,1,5,xiaomi_mi_11-22,2077,42525
Xiaomi Mi 11,683,65800,110250,96915,4,2,xiaomi_mi_11-23,2078,13335
Xiaomi Mi 11,820,60200,119700,103338,4,1,xiaomi_mi_11-24,2079,16362
iPhone SE (2022),260,43500,86250,73425,5,2,iphone_se_2022-0,2080,12825
iPhone SE (2022),172,44500,85500,59670,2,4,iphone_se_2022-1,2081,25830
iPhone SE (2022),719,49500,84000,59160,1,2,iphone_se_2022-2,2082,24840
iPhone SE (2022),172,47500,78000,50550,1,5,iphone_se_2022-3,2083,27450
iPhone SE (2022),505,46000,77250,51000,1,4,iphone_se_2022-4,2084,26250
iPhone SE (2022),163,44500,80250,69525,4,2,iphone_se_2022-5,2085,10725
iPhone SE (2022),603,45500,80250,68957,5,3,iphone_se_2022-6,2086,11293
iPhone SE (2022),481,47000,77250,68932,4,1,iphone_se_2022-7,2087,8318
iPhone SE (2022),560,43000,86250,60949,2,3,iphone_se_2022-8,2088,25301
iPhone SE (2022),131,48000,78750,67988,4,4,iphone_se_2022-9,2089,10762
iPhone SE (2022),990,46500,85500,73800,4,2,iphone_se_2022-10,2090,11700
iPhone SE (2022),225,43000,78750,64987,3,1,iphone_se_2022-11,2091,13763
iPhone SE (2022),339,48500,79500,70975,5,1,iphone_se_2022-12,2092,8525
iPhone SE (2022),597,44000,84000,57600,1,1,iphone_se_2022-13,2093,26400
iPhone SE (2022),925,47000,76500,53490,1,3,iphone_se_2022-14,2094,23010
iPhone SE (2022),437,49500,81000,61155,2,4,iphone_se_2022-15,2095,19845
iPhone SE (2022),442,46500,81750,63244,3,5,iphone_se_2022-16,2096,18506
iPhone SE (2022),442,49000,80250,63844,3,5,iphone_se_2022-17,2097,16406
iPhone SE (2022),753,44000,75750,55748,2,4,iphone_se_2022-18,2098,20002
iPhone SE (2022),821,45000,77250,58384,2,3,iphone_se_2022-19,2099,18866
iPhone SE (2022),822,45500,75750,56693,2,4,iphone_se_2022-20,2100,19057
iPhone SE (2022),63,46500,76500,51300,1,4,iphone_se_2022-21,2101,25200
iPhone SE (2022),867,48000,84750,70602,3,1,iphone_se_2022-22,2102,14148
iPhone SE (2022),524,43000,84000,49560,1,4,iphone_se_2022-23,2103,34440
iPhone SE (2022),542,43000,78000,64875,5,5,iphone_se_2022-24,2104,13125
iPhone SE (2022),559,45000,81750,71644,4,1,iphone_se_2022-25,2105,10106
iPhone SE (2022),336,43500,76500,58680,2,2,iphone_se_2022-26,2106,17820
Samsung Galaxy Z Fold 3,789,141000,236250,210057,4,1,samsung_galaxy_z_fold_3-0,2107,26193
Samsung Galaxy Z Fold 3,72,142500,258750,223875,4,2,samsung_galaxy_z_fold_3-1,2108,34875
Samsung Galaxy Z Fold 3,894,135000,247500,210938,5,3,samsung_galaxy_z_fold_3-2,2109,36562
Samsung Galaxy Z Fold 3,947,135000,234000,171630,2,4,samsung_galaxy_z_fold_3-3,2110,62370
Samsung Galaxy Z Fold 3,284,130500,256500,173340,1,1,samsung_galaxy_z_fold_3-4,2111,83160
Samsung Galaxy Z Fold 3,533,139500,234000,170213,2,5,samsung_galaxy_z_fold_3-5,2112,63787
Samsung Galaxy Z Fold 3,807,136500,238500,174240,2,4,samsung_galaxy_z_fold_3-6,2113,64260
Samsung Galaxy Z Fold 3,634,135000,245250,152640,1,4,samsung_galaxy_z_fold_3-7,2114,92610
Samsung Galaxy Z Fold 3,639,147000,249750,211219,5,5,samsung_galaxy_z_fold_3-8,2115,38531
Samsung Galaxy Z Fold 3,407,127500,243000,208350,4,2,samsung_galaxy_z_fold_3-9,2116,34650
Samsung Galaxy Z Fold 3,239,142500,249750,191835,2,2,samsung_galaxy_z_fold_3-10,2117,57915
Samsung Galaxy Z Fold 3,674,148500,231750,193872,3,3,samsung_galaxy_z_fold_3-11,2118,37878
Samsung Galaxy Z Fold 3,188,130500,247500,189585,2,1,samsung_galaxy_z_fold_3-12,2119,57915
Samsung Galaxy Z Fold 3,161,147000,234000,207900,4,2,samsung_galaxy_z_fold_3-13,2120,26100
Samsung Galaxy Z Fold 3,194,138000,243000,214125,5,1,samsung_galaxy_z_fold_3-14,2121,28875
Samsung Galaxy Z Fold 3,561,133500,234000,184253,2,1,samsung_galaxy_z_fold_3-15,2122,49747
Samsung Galaxy Z Fold 3,888,141000,231750,196812,3,1,samsung_galaxy_z_fold_3-16,2123,34938
Samsung Galaxy Z Fold 3,294,138000,243000,187875,3,5,samsung_galaxy_z_fold_3-17,2124,55125
Samsung Galaxy Z Fold 3,881,138000,231750,192375,3,2,samsung_galaxy_z_fold_3-18,2125,39375
Samsung Galaxy Z Fold 3,101,136500,243000,211050,4,2,samsung_galaxy_z_fold_3-19,2126,31950
Samsung Galaxy Z Fold 3,481,130500,236250,195537,3,1,samsung_galaxy_z_fold_3-20,2127,40713
Samsung Galaxy Z Fold 3,665,135000,234000,185490,3,4,samsung_galaxy_z_fold_3-21,2128,48510
Samsung Galaxy Z Fold 3,734,132000,245250,163710,1,2,samsung_galaxy_z_fold_3-22,2129,81540
Samsung Galaxy Z Fold 3,34,139500,231750,199463,5,4,samsung_galaxy_z_fold_3-23,2130,32287
Samsung Galaxy Z Fold 3,736,145500,247500,216900,4,2,samsung_galaxy_z_fold_3-24,2131,30600
Samsung Galaxy Z Fold 3,867,132000,247500,157410,1,3,samsung_galaxy_z_fold_3-25,2132,90090
Samsung Galaxy Z Fold 3,805,136500,252000,211575,4,4,samsung_galaxy_z_fold_3-26,2133,40425
Samsung Galaxy Z Fold 3,926,127500,254250,140175,1,5,samsung_galaxy_z_fold_3-27,2134,114075
Samsung Galaxy Z Fold 3,249,133500,252000,216450,4,2,samsung_galaxy_z_fold_3-28,2135,35550
Google Pixel Buds 2,96,8800,15600,13730,5,1,google_pixel_buds_2-0,2136,1870
Google Pixel Buds 2,236,8800,16650,11705,2,4,google_pixel_buds_2-1,2137,4945
Google Pixel Buds 2,863,9000,15150,13305,5,2,google_pixel_buds_2-2,2138,1845
Google Pixel Buds 2,700,9000,16650,10224,1,4,google_pixel_buds_2-3,2139,6426
Google Pixel Buds 2,96,9400,16800,14210,5,4,google_pixel_buds_2-4,2140,2590
Google Pixel Buds 2,986,8900,16950,14737,4,1,google_pixel_buds_2-5,2141,2213
Google Pixel Buds 2,22,8900,16050,13905,4,2,google_pixel_buds_2-6,2142,2145
Google Pixel Buds 2,255,9700,15300,13480,5,3,google_pixel_buds_2-7,2143,1820
Google Pixel Buds 2,32,8600,17250,10503,1,3,google_pixel_buds_2-8,2144,6747
Google Pixel Buds 2,547,9700,15750,13935,5,2,google_pixel_buds_2-9,2145,1815
Google Pixel Buds 2,29,9800,16800,13335,2,1,google_pixel_buds_2-10,2146,3465
Google Pixel Buds 2,259,9500,16350,13713,3,1,google_pixel_buds_2-11,2147,2637
Google Pixel Buds 2,983,9700,16800,12008,2,5,google_pixel_buds_2-12,2148,4792
Google Pixel Buds 2,247,9000,15300,12434,3,3,google_pixel_buds_2-13,2149,2866
Google Pixel Buds 2,208,9400,15750,12607,2,1,google_pixel_buds_2-14,2150,3143
Google Pixel Buds 2,562,9000,15600,13455,4,3,google_pixel_buds_2-15,2151,2145
Google Pixel Buds 2,249,9200,15600,12912,3,2,google_pixel_buds_2-16,2152,2688
Google Pixel Buds 2,614,9200,15750,12312,3,5,google_pixel_buds_2-17,2153,3438
Google Pixel Buds 2,486,8700,16950,14063,4,4,google_pixel_buds_2-18,2154,2887
Google Pixel Buds 2,755,9400,16800,13692,3,2,google_pixel_buds_2-19,2155,3108
AirPods Pro,263,22500,37875,33647,5,1,airpods_pro-0,2156,4228
AirPods Pro,757,24500,39750,32278,3,4,airpods_pro-1,2157,7472
AirPods Pro,701,23000,42375,32204,3,5,airpods_pro-2,2158,10171
AirPods Pro,218,24500,38625,29091,2,5,airpods_pro-3,2159,9534
AirPods Pro,94,22500,40500,33570,3,1,airpods_pro-4,2160,6930
AirPods Pro,392,22250,40500,27360,1,2,airpods_pro-5,2161,13140
AirPods Pro,875,21750,41250,34913,5,3,airpods_pro-6,2162,6337
AirPods Pro,815,22500,40875,28748,1,1,airpods_pro-7,2163,12127
AirPods Pro,35,22000,40125,35141,5,1,airpods_pro-8,2164,4984
AirPods Pro,168,22000,41250,28545,1,1,airpods_pro-9,2165,12705
AirPods Pro,834,24000,42750,30938,2,4,airpods_pro-10,2166,11812
AirPods Pro,206,21250,41625,23288,1,5,airpods_pro-11,2167,18337
AirPods Pro,805,21250,42750,31140,2,2,airpods_pro-12,2168,11610
AirPods Pro,263,22000,42750,36007,4,3,airpods_pro-13,2169,6743
AirPods Pro,280,23250,42375,32909,2,1,airpods_pro-14,2170,9466
AirPods Pro,158,21250,40875,32633,3,2,airpods_pro-15,2171,8242
AirPods Pro,712,22750,38625,33863,5,2,airpods_pro-16,2172,4762
AirPods Pro,699,23250,40500,31444,3,5,airpods_pro-17,2173,9056
AirPods Pro,515,21750,41625,34172,5,5,airpods_pro-18,2174,7453
AirPods Pro,506,24500,40875,35144,4,4,airpods_pro-19,2175,5731
AirPods Pro,169,22500,39000,26130,1,3,airpods_pro-20,2176,12870
AirPods Pro,468,21750,42750,36450,4,2,airpods_pro-21,2177,6300
AirPods Pro,842,22250,39750,33188,5,5,airpods_pro-22,2178,6562
Samsung Galaxy Watch 4,275,30450,59850,48825,4,5,samsung_galaxy_watch_4-0,2179,11025
Samsung Galaxy Watch 4,71,30450,59850,51030,5,2,samsung_galaxy_watch_4-1,2180,8820
Samsung Galaxy Watch 4,65,30800,58800,40320,1,1,samsung_galaxy_watch_4-2,2181,18480
Samsung Galaxy Watch 4,151,32550,55650,49298,5,1,samsung_galaxy_watch_4-3,2182,6352
Samsung Galaxy Watch 4,200,34300,56700,50540,5,1,samsung_galaxy_watch_4-4,2183,6160
Samsung Galaxy Watch 4,653,34300,54600,49018,5,1,samsung_galaxy_watch_4-5,2184,5582
Samsung Galaxy Watch 4,522,31500,58275,49574,4,3,samsung_galaxy_watch_4-6,2185,8701
Samsung Galaxy Watch 4,470,33250,58275,50142,5,3,samsung_galaxy_watch_4-7,2186,8133
Samsung Galaxy Watch 4,344,32550,53025,46371,4,3,samsung_galaxy_watch_4-8,2187,6654
Samsung Galaxy Watch 4,365,33600,53025,44187,3,3,samsung_galaxy_watch_4-9,2188,8838
Samsung Galaxy Watch 4,481,29750,56700,48615,5,2,samsung_galaxy_watch_4-10,2189,8085
Samsung Galaxy Watch 4,316,30800,59850,41549,2,4,samsung_galaxy_watch_4-11,2190,18301
Samsung Galaxy Watch 4,488,34650,58800,41412,1,2,samsung_galaxy_watch_4-12,2191,17388
Samsung Galaxy Watch 4,471,31850,60375,46398,3,4,samsung_galaxy_watch_4-13,2192,13977
Samsung Galaxy Watch 4,952,31150,59325,45520,3,4,samsung_galaxy_watch_4-14,2193,13805
Samsung Galaxy Watch 4,441,29750,58275,47579,5,5,samsung_galaxy_watch_4-15,2194,10696
Samsung Galaxy Watch 4,354,29750,59325,51192,5,1,samsung_galaxy_watch_4-16,2195,8133
Samsung Galaxy Watch 4,721,31850,56700,40299,1,1,samsung_galaxy_watch_4-17,2196,16401
Samsung Galaxy Watch 4,844,30450,53025,40835,2,2,samsung_galaxy_watch_4-18,2197,12190
Samsung Galaxy Watch 4,487,32200,57750,37821,1,3,samsung_galaxy_watch_4-19,2198,19929
Fitbit Charge 5,207,14100,24750,21822,5,1,fitbit_charge_5-0,2199,2928
Fitbit Charge 5,306,12900,25875,22307,5,1,fitbit_charge_5-1,2200,3568
Fitbit Charge 5,258,13050,22950,17753,3,5,fitbit_charge_5-2,2201,5197
Fitbit Charge 5,140,14700,22725,19917,4,4,fitbit_charge_5-3,2202,2808
Fitbit Charge 5,215,13200,25425,22064,4,1,fitbit_charge_5-4,2203,3361
Fitbit Charge 5,773,14250,22950,18992,3,3,fitbit_charge_5-5,2204,3958
Fitbit Charge 5,93,13350,23625,19310,3,2,fitbit_charge_5-6,2205,4315
Fitbit Charge 5,692,13500,22725,16914,2,4,fitbit_charge_5-7,2206,5811
Fitbit Charge 5,759,13950,23400,18723,2,1,fitbit_charge_5-8,2207,4677
Fitbit Charge 5,402,13200,25200,19320,3,4,fitbit_charge_5-9,2208,5880
Fitbit Charge 5,81,14100,24975,20408,3,2,fitbit_charge_5-10,2209,4567
Fitbit Charge 5,852,14550,25425,21619,4,4,fitbit_charge_5-11,2210,3806
Fitbit Charge 5,528,14250,25650,20064,3,4,fitbit_charge_5-12,2211,5586
Fitbit Charge 5,788,13500,23625,18310,3,5,fitbit_charge_5-13,2212,5315
Fitbit Charge 5,329,14100,22950,18570,2,1,fitbit_charge_5-14,2213,4380
Fitbit Charge 5,269,13950,25425,21008,3,1,fitbit_charge_5-15,2214,4417
Fitbit Charge 5,955,13200,22725,15867,1,2,fitbit_charge_5-16,2215,6858
Fitbit Charge 5,485,13950,24075,20785,4,3,fitbit_charge_5-17,2216,3290
Fitbit Charge 5,23,13350,25425,21501,5,3,fitbit_charge_5-18,2217,3924
Fitbit Charge 5,996,13950,22950,19575,5,5,fitbit_charge_5-19,2218,3375
Fitbit Charge 5,473,13350,24525,19441,3,3,fitbit_charge_5-20,2219,5084
OnePlus Buds Pro,836,8600,15300,10878,1,1,oneplus_buds_pro-0,2220,4422
OnePlus Buds Pro,62,8800,17250,14927,5,1,oneplus_buds_pro-1,2221,2323
OnePlus Buds Pro,689,8600,15450,10827,2,5,oneplus_buds_pro-2,2222,4623
OnePlus Buds Pro,832,8800,16050,12244,3,5,oneplus_buds_pro-3,2223,3806
OnePlus Buds Pro,792,8700,15750,11943,2,2,oneplus_buds_pro-4,2224,3807
OnePlus Buds Pro,30,8600,17250,14655,4,2,oneplus_buds_pro-5,2225,2595
OnePlus Buds Pro,310,9100,15450,12117,3,5,oneplus_buds_pro-6,2226,3333
OnePlus Buds Pro,91,9200,16950,14044,5,5,oneplus_buds_pro-7,2227,2906
OnePlus Buds Pro,658,8800,16200,12537,2,1,oneplus_buds_pro-8,2228,3663
OnePlus Buds Pro,90,9500,16950,12927,2,2,oneplus_buds_pro-9,2229,4023
OnePlus Buds Pro,50,8700,15150,12216,3,3,oneplus_buds_pro-10,2230,2934
OnePlus Buds Pro,622,9000,15750,12443,3,4,oneplus_buds_pro-11,2231,3307
OnePlus Buds Pro,965,9800,15300,13375,4,4,oneplus_buds_pro-12,2232,1925
OnePlus Buds Pro,191,9300,17100,11835,2,5,oneplus_buds_pro-13,2233,5265
OnePlus Buds Pro,989,8500,15300,11016,2,4,oneplus_buds_pro-14,2234,4284
OnePlus Buds Pro,845,9200,15450,11794,2,3,oneplus_buds_pro-15,2235,3656
OnePlus Buds Pro,715,9300,15600,13175,3,1,oneplus_buds_pro-16,2236,2425
OnePlus Buds Pro,774,8900,15150,12307,3,3,oneplus_buds_pro-17,2237,2843
OnePlus Buds Pro,795,9300,15300,12150,3,5,oneplus_buds_pro-18,2238,3150
OnePlus Buds Pro,448,9800,16950,11802,1,2,oneplus_buds_pro-19,2239,5148
OnePlus Buds Pro,713,9500,15900,13660,5,4,oneplus_buds_pro-20,2240,2240
OnePlus Buds Pro,711,9400,16200,14330,5,1,oneplus_buds_pro-21,2241,1870
OnePlus Buds Pro,773,9700,16800,12327,2,4,oneplus_buds_pro-22,2242,4473
Xiaomi Mi Band 6,543,4250,8550,5841,2,4,xiaomi_mi_band_6-0,2243,2709
Xiaomi Mi Band 6,448,4650,8625,5048,1,5,xiaomi_mi_band_6-1,2244,3577
Xiaomi Mi Band 6,43,4900,8550,5265,1,5,xiaomi_mi_band_6-2,2245,3285
Xiaomi Mi Band 6,984,4850,8175,6929,4,5,xiaomi_mi_band_6-3,2246,1246
Xiaomi Mi Band 6,318,4850,7725,6719,4,4,xiaomi_mi_band_6-4,2247,1006
Xiaomi Mi Band 6,326,4700,8400,5736,1,2,xiaomi_mi_band_6-5,2248,2664
Xiaomi Mi Band 6,134,4400,8325,6383,2,1,xiaomi_mi_band_6-6,2249,1942
Xiaomi Mi Band 6,509,4550,7575,4853,1,5,xiaomi_mi_band_6-7,2250,2722
Xiaomi Mi Band 6,893,4800,7800,6540,3,2,xiaomi_mi_band_6-8,2251,1260
Xiaomi Mi Band 6,175,4250,7650,6375,4,5,xiaomi_mi_band_6-9,2252,1275
Xiaomi Mi Band 6,404,4850,7800,5676,1,2,xiaomi_mi_band_6-10,2253,2124
Xiaomi Mi Band 6,740,4300,7950,6582,5,5,xiaomi_mi_band_6-11,2254,1368
Xiaomi Mi Band 6,534,4350,7875,6642,4,4,xiaomi_mi_band_6-12,2255,1233
Xiaomi Mi Band 6,157,4550,7650,6457,3,1,xiaomi_mi_band_6-13,2256,1193
Xiaomi Mi Band 6,160,4850,7950,6323,3,5,xiaomi_mi_band_6-14,2257,1627
Xiaomi Mi Band 6,446,4350,8400,6882,5,5,xiaomi_mi_band_6-15,2258,1518
Xiaomi Mi Band 6,690,4300,8100,6675,5,5,xiaomi_mi_band_6-16,2259,1425
Xiaomi Mi Band 6,845,4350,8100,6882,4,3,xiaomi_mi_band_6-17,2260,1218
Xiaomi Mi Band 6,788,4350,8475,7032,4,4,xiaomi_mi_band_6-18,2261,1443
Xiaomi Mi Band 6,439,4650,7575,5601,2,5,xiaomi_mi_band_6-19,2262,1974
Xiaomi Mi Band 6,165,4700,8025,6080,2,3,xiaomi_mi_band_6-20,2263,1945
Xiaomi Mi Band 6,238,4700,7575,6469,3,1,xiaomi_mi_band_6-21,2264,1106
Xiaomi Mi Band 6,617,4800,7875,6799,4,4,xiaomi_mi_band_6-22,2265,1076
Xiaomi Mi Band 6,433,4850,8100,7207,5,1,xiaomi_mi_band_6-23,2266,893
Xiaomi Mi Band 6,464,4750,8025,5274,1,4,xiaomi_mi_band_6-24,2267,2751
Xiaomi Mi Band 6,739,4800,8400,5970,2,5,xiaomi_mi_band_6-25,2268,2430
Xiaomi Mi Band 6,666,4950,8475,5726,1,3,xiaomi_mi_band_6-26,2269,2749
iPhone 13 Pro Max,458,108000,205200,143964,2,4,iphone_13_pro_max-0,2270,61236
iPhone 13 Pro Max,599,105600,190800,167370,4,1,iphone_13_pro_max-1,2271,23430
iPhone 13 Pro Max,813,117600,190800,165180,4,4,iphone_13_pro_max-2,2272,25620
iPhone 13 Pro Max,604,105600,198000,167970,4,3,iphone_13_pro_max-3,2273,30030
iPhone 13 Pro Max,454,109200,205200,136080,1,2,iphone_13_pro_max-4,2274,69120
iPhone 13 Pro Max,609,112800,205200,169626,3,1,iphone_13_pro_max-5,2275,35574
iPhone 13 Pro Max,719,106800,183600,160560,5,2,iphone_13_pro_max-6,2276,23040
iPhone 13 Pro Max,29,112800,189000,129564,1,3,iphone_13_pro_max-7,2277,59436
iPhone 13 Pro Max,851,105600,192600,153015,3,3,iphone_13_pro_max-8,2278,39585
iPhone 13 Pro Max,496,110400,194400,171300,4,1,iphone_13_pro_max-9,2279,23100
iPhone 13 Pro Max,728,102000,207000,159225,3,3,iphone_13_pro_max-10,2280,47775
iPhone 13 Pro Max,762,112800,199800,154126,3,5,iphone_13_pro_max-11,2281,45674
iPhone 13 Pro Max,56,105600,189000,161895,5,3,iphone_13_pro_max-12,2282,27105
iPhone 13 Pro Max,685,117600,192600,163725,3,1,iphone_13_pro_max-13,2283,28875
iPhone 13 Pro Max,424,105600,190800,163110,5,3,iphone_13_pro_max-14,2284,27690
iPhone 13 Pro Max,53,104400,189000,150507,3,3,iphone_13_pro_max-15,2285,38493
iPhone 13 Pro Max,558,102000,185400,154125,5,5,iphone_13_pro_max-16,2286,31275
iPhone 13 Pro Max,206,117600,192600,170100,5,2,iphone_13_pro_max-17,2287,22500
iPhone 13 Pro Max,784,105600,198000,172590,5,1,iphone_13_pro_max-18,2288,25410
iPhone 13 Pro Max,546,102000,190800,138852,2,3,iphone_13_pro_max-19,2289,51948
iPhone 13 Pro Max,243,109200,199800,155406,3,4,iphone_13_pro_max-20,2290,44394
iPhone 13 Pro Max,995,110400,192600,138348,1,1,iphone_13_pro_max-21,2291,54252
iPhone 13 Pro Max,645,104400,181800,152775,5,5,iphone_13_pro_max-22,2292,29025
iPhone 13 Pro Max,897,110400,192600,161775,4,5,iphone_13_pro_max-23,2293,30825
iPhone 13 Pro Max,240,114000,196200,161676,3,2,iphone_13_pro_max-24,2294,34524
iPhone 13 Pro Max,172,109200,207000,170325,4,5,iphone_13_pro_max-25,2295,36675
iPhone 13 Pro Max,172,108000,181800,154125,4,5,iphone_13_pro_max-26,2296,27675
iPhone 13 Pro Max,586,104400,199800,143991,2,3,iphone_13_pro_max-27,2297,55809
iPhone 13 Pro Max,122,111600,181800,135468,1,1,iphone_13_pro_max-28,2298,46332
Samsung Galaxy Note 20 Ultra,999,69600,130800,112440,4,2,samsung_galaxy_note_20_ultra-0,2299,18360
Samsung Galaxy Note 20 Ultra,745,77600,127200,112320,4,2,samsung_galaxy_note_20_ultra-1,2300,14880
Samsung Galaxy Note 20 Ultra,447,76000,122400,109640,5,1,samsung_galaxy_note_20_ultra-2,2301,12760
Samsung Galaxy Note 20 Ultra,869,72800,129600,96372,2,3,samsung_galaxy_note_20_ultra-3,2302,33228
Samsung Galaxy Note 20 Ultra,870,75200,124800,108680,5,3,samsung_galaxy_note_20_ultra-4,2303,16120
Samsung Galaxy Note 20 Ultra,841,76800,133200,109512,3,2,samsung_galaxy_note_20_ultra-5,2304,23688
Samsung Galaxy Note 20 Ultra,320,79200,122400,83520,1,5,samsung_galaxy_note_20_ultra-6,2305,38880
Samsung Galaxy Note 20 Ultra,521,71200,123600,76440,1,5,samsung_galaxy_note_20_ultra-7,2306,47160
Samsung Galaxy Note 20 Ultra,596,68000,138000,111750,4,5,samsung_galaxy_note_20_ultra-8,2307,26250
Samsung Galaxy Note 20 Ultra,414,78400,136800,119280,5,2,samsung_galaxy_note_20_ultra-9,2308,17520
Samsung Galaxy Note 20 Ultra,915,69600,121200,91014,2,3,samsung_galaxy_note_20_ultra-10,2309,30186
Samsung Galaxy Note 20 Ultra,629,68800,136800,90900,2,5,samsung_galaxy_note_20_ultra-11,2310,45900
Samsung Galaxy Note 20 Ultra,874,68000,136800,114440,5,3,samsung_galaxy_note_20_ultra-12,2311,22360
Samsung Galaxy Note 20 Ultra,52,76800,123600,108390,4,3,samsung_galaxy_note_20_ultra-13,2312,15210
Samsung Galaxy Note 20 Ultra,888,76800,133200,100206,2,3,samsung_galaxy_note_20_ultra-14,2313,32994
Samsung Galaxy Note 20 Ultra,293,73600,127200,95844,2,3,samsung_galaxy_note_20_ultra-15,2314,31356
Samsung Galaxy Note 20 Ultra,673,71200,129600,100692,2,1,samsung_galaxy_note_20_ultra-16,2315,28908
Samsung Galaxy Note 20 Ultra,156,72000,129600,81216,1,4,samsung_galaxy_note_20_ultra-17,2316,48384
Samsung Galaxy Note 20 Ultra,37,68800,122400,104980,5,3,samsung_galaxy_note_20_ultra-18,2317,17420
Samsung Galaxy Note 20 Ultra,288,76000,121200,106510,4,3,samsung_galaxy_note_20_ultra-19,2318,14690
Samsung Galaxy Note 20 Ultra,642,79200,128400,113640,4,2,samsung_galaxy_note_20_ultra-20,2319,14760
Samsung Galaxy Note 20 Ultra,712,75200,124800,92064,1,1,samsung_galaxy_note_20_ultra-21,2320,32736
Samsung Galaxy Note 20 Ultra,66,69600,128400,86064,1,2,samsung_galaxy_note_20_ultra-22,2321,42336
Samsung Galaxy Note 20 Ultra,83,73600,133200,83136,1,4,samsung_galaxy_note_20_ultra-23,2322,50064
Samsung Galaxy Note 20 Ultra,592,68800,138000,106514,3,3,samsung_galaxy_note_20_ultra-24,2323,31486
Google Pixel Stand,859,4600,8325,7115,4,3,google_pixel_stand-0,2324,1210
Google Pixel Stand,888,4400,8025,7029,5,1,google_pixel_stand-1,2325,996
Google Pixel Stand,463,4450,8175,5829,2,4,google_pixel_stand-2,2326,2346
Google Pixel Stand,225,4250,7650,5406,1,1,google_pixel_stand-3,2327,2244
Google Pixel Stand,598,4600,7725,6038,2,2,google_pixel_stand-4,2328,1687
Google Pixel Stand,822,4650,8025,4988,1,5,google_pixel_stand-5,2329,3037
Google Pixel Stand,397,4400,7875,6920,4,1,google_pixel_stand-6,2330,955
Google Pixel Stand,202,4350,8550,5715,2,5,google_pixel_stand-7,2331,2835
Google Pixel Stand,113,4500,8025,5276,1,3,google_pixel_stand-8,2332,2749
Google Pixel Stand,447,4400,7650,6432,5,5,google_pixel_stand-9,2333,1218
Google Pixel Stand,663,4600,7725,6413,3,2,google_pixel_stand-10,2334,1312
Google Pixel Stand,171,4550,8100,5757,1,1,google_pixel_stand-11,2335,2343
Google Pixel Stand,499,4700,8175,7133,5,2,google_pixel_stand-12,2336,1042
Google Pixel Stand,102,4750,8250,6413,3,5,google_pixel_stand-13,2337,1837
Google Pixel Stand,251,4350,8325,6835,4,5,google_pixel_stand-14,2338,1490
Google Pixel Stand,258,4700,8625,6153,2,4,google_pixel_stand-15,2339,2472
Google Pixel Stand,924,4700,7800,5754,1,1,google_pixel_stand-16,2340,2046
Google Pixel Stand,257,4300,7950,5979,2,2,google_pixel_stand-17,2341,1971
Google Pixel Stand,81,4850,8025,7073,4,2,google_pixel_stand-18,2342,952
Google Pixel Stand,937,4850,7575,6240,3,4,google_pixel_stand-19,2343,1335
Google Pixel Stand,321,4250,7650,5967,2,1,google_pixel_stand-20,2344,1683
Google Pixel Stand,72,4450,8475,5577,1,2,google_pixel_stand-21,2345,2898
Google Pixel Stand,633,4600,8175,5816,1,1,google_pixel_stand-22,2346,2359
Google Pixel Stand,487,4850,8025,5358,1,4,google_pixel_stand-23,2347,2667
Google Pixel Stand,485,4800,7950,5115,1,5,google_pixel_stand-24,2348,2835
AirPods Max,225,46000,84750,59175,1,1,airpods_max-0,2349,25575
AirPods Max,763,45000,81000,52920,1,3,airpods_max-1,2350,28080
AirPods Max,953,47000,86250,60345,1,1,airpods_max-2,2351,25905
AirPods Max,617,45500,83250,58335,1,1,airpods_max-3,2352,24915
AirPods Max,509,49500,85500,72000,4,5,airpods_max-4,2353,13500
AirPods Max,816,43000,86250,71113,5,4,airpods_max-5,2354,15137
AirPods Max,788,45500,84000,58590,1,1,airpods_max-6,2355,25410
AirPods Max,111,43000,82500,68675,5,4,airpods_max-7,2356,13825
AirPods Max,224,48500,84750,73875,5,2,airpods_max-8,2357,10875
AirPods Max,300,46500,75750,66244,5,3,airpods_max-9,2358,9506
AirPods Max,796,43000,80250,66282,5,5,airpods_max-10,2359,13968
AirPods Max,804,42500,84000,59723,2,3,airpods_max-11,2360,24277
AirPods Max,377,49000,77250,66657,5,5,airpods_max-12,2361,10593
AirPods Max,171,44500,80250,50220,1,4,airpods_max-13,2362,30030
AirPods Max,24,43000,77250,67832,5,1,airpods_max-14,2363,9418
AirPods Max,563,47500,83250,73419,4,1,airpods_max-15,2364,9831
AirPods Max,672,44500,86250,71638,5,4,airpods_max-16,2365,14612
AirPods Max,810,48000,81750,63525,2,2,airpods_max-17,2366,18225
AirPods Max,395,42500,81750,58789,2,3,airpods_max-18,2367,22961
AirPods Max,305,49000,76500,58350,1,1,airpods_max-19,2368,18150
AirPods Max,875,43500,78750,65532,4,5,airpods_max-20,2369,13218
AirPods Max,219,49500,82500,72600,4,2,airpods_max-21,2370,9900
AirPods Max,80,42500,86250,54750,1,2,airpods_max-22,2371,31500
AirPods Max,871,44500,78750,60255,2,2,airpods_max-23,2372,18495
AirPods Max,411,48000,82500,51450,1,5,airpods_max-24,2373,31050
Samsung Galaxy Buds Pro,99,14550,24750,21690,4,2,samsung_galaxy_buds_pro-0,2374,3060
Samsung Galaxy Buds Pro,586,13950,23850,15534,1,4,samsung_galaxy_buds_pro-1,2375,8316
Samsung Galaxy Buds Pro,89,13200,22950,19782,4,3,samsung_galaxy_buds_pro-2,2376,3168
Samsung Galaxy Buds Pro,299,12900,24525,20050,3,1,samsung_galaxy_buds_pro-3,2377,4475
Samsung Galaxy Buds Pro,797,12900,23850,20839,5,1,samsung_galaxy_buds_pro-4,2378,3011
Samsung Galaxy Buds Pro,762,13500,24300,20520,4,4,samsung_galaxy_buds_pro-5,2379,3780
Samsung Galaxy Buds Pro,444,13650,23175,19842,5,4,samsung_galaxy_buds_pro-6,2380,3333
Samsung Galaxy Buds Pro,51,13050,25425,20661,3,1,samsung_galaxy_buds_pro-7,2381,4764
Samsung Galaxy Buds Pro,41,14100,24975,21713,4,2,samsung_galaxy_buds_pro-8,2382,3262
Samsung Galaxy Buds Pro,906,13650,24075,16569,1,2,samsung_galaxy_buds_pro-9,2383,7506
Samsung Galaxy Buds Pro,947,14400,22950,17564,2,4,samsung_galaxy_buds_pro-10,2384,5386
Samsung Galaxy Buds Pro,879,14700,25650,16452,1,4,samsung_galaxy_buds_pro-11,2385,9198
Samsung Galaxy Buds Pro,940,13650,25425,19597,2,1,samsung_galaxy_buds_pro-12,2386,5828
Samsung Galaxy Buds Pro,122,14700,23850,20648,5,4,samsung_galaxy_buds_pro-13,2387,3202
Samsung Galaxy Buds Pro,756,14850,24750,21038,5,5,samsung_galaxy_buds_pro-14,2388,3712
Samsung Galaxy Buds Pro,293,12750,24750,19290,3,3,samsung_galaxy_buds_pro-15,2389,5460
Samsung Galaxy Buds Pro,137,14550,22950,19716,3,1,samsung_galaxy_buds_pro-16,2390,3234
Samsung Galaxy Buds Pro,293,14700,24975,15728,1,5,samsung_galaxy_buds_pro-17,2391,9247
Samsung Galaxy Buds Pro,550,13950,25425,17852,1,1,samsung_galaxy_buds_pro-18,2392,7573
Samsung Galaxy Buds Pro,403,13800,24075,18989,2,1,samsung_galaxy_buds_pro-19,2393,5086
Samsung Galaxy Buds Pro,434,14700,23625,19208,2,1,samsung_galaxy_buds_pro-20,2394,4417
Samsung Galaxy Buds Pro,218,13350,25425,20897,5,5,samsung_galaxy_buds_pro-21,2395,4528
Samsung Galaxy Buds Pro,984,13050,24075,14814,1,4,samsung_galaxy_buds_pro-22,2396,9261
Samsung Galaxy Buds Pro,851,14400,24975,21803,4,2,samsung_galaxy_buds_pro-23,2397,3172
Samsung Galaxy Buds Pro,573,14850,25650,19981,3,5,samsung_galaxy_buds_pro-24,2398,5669
OnePlus Nord 2,75,29400,50850,41091,3,3,oneplus_nord_2-0,2399,9759
OnePlus Nord 2,338,27000,49500,41063,4,5,oneplus_nord_2-1,2400,8437
OnePlus Nord 2,808,25500,51750,38888,3,4,oneplus_nord_2-2,2401,12862
OnePlus Nord 2,89,29700,46350,40939,5,3,oneplus_nord_2-3,2402,5411
OnePlus Nord 2,397,27900,47250,41445,5,2,oneplus_nord_2-4,2403,5805
OnePlus Nord 2,180,28800,49500,35528,2,5,oneplus_nord_2-5,2404,13972
OnePlus Nord 2,608,25500,47700,34713,2,3,oneplus_nord_2-6,2405,12987
OnePlus Nord 2,736,25800,50850,40329,3,2,oneplus_nord_2-7,2406,10521
OnePlus Nord 2,345,28200,49500,41513,5,5,oneplus_nord_2-8,2407,7987
OnePlus Nord 2,887,25800,49500,34569,2,4,oneplus_nord_2-9,2408,14931
OnePlus Nord 2,251,28500,46800,38474,3,3,oneplus_nord_2-10,2409,8326
OnePlus Nord 2,621,26100,49050,40444,4,5,oneplus_nord_2-11,2410,8606
OnePlus Nord 2,858,27000,50850,44292,5,1,oneplus_nord_2-12,2411,6558
OnePlus Nord 2,749,28800,48600,41670,5,4,oneplus_nord_2-13,2412,6930
OnePlus Nord 2,138,28200,48150,31392,1,4,oneplus_nord_2-14,2413,16758
OnePlus Nord 2,196,29700,49050,38601,2,2,oneplus_nord_2-15,2414,10449
OnePlus Nord 2,427,27600,48600,38310,3,4,oneplus_nord_2-16,2415,10290
OnePlus Nord 2,965,29100,51750,43823,4,4,oneplus_nord_2-17,2416,7927
OnePlus Nord 2,567,25800,50850,32814,1,2,oneplus_nord_2-18,2417,18036
OnePlus Nord 2,775,26400,51300,38228,3,5,oneplus_nord_2-19,2418,13072
OnePlus Nord 2,268,29700,47250,42424,5,1,oneplus_nord_2-20,2419,4826
Xiaomi Redmi Note 11,330,12900,24075,21002,5,1,xiaomi_redmi_note_11-0,2420,3073
Xiaomi Redmi Note 11,234,13500,25425,18986,2,2,xiaomi_redmi_note_11-1,2421,6439
Xiaomi Redmi Note 11,415,14250,23625,17719,2,4,xiaomi_redmi_note_11-2,2422,5906
Xiaomi Redmi Note 11,988,14550,25875,17721,1,2,xiaomi_redmi_note_11-3,2423,8154
Xiaomi Redmi Note 11,462,13200,23175,17789,2,2,xiaomi_redmi_note_11-4,2424,5386
Xiaomi Redmi Note 11,628,14100,24525,19417,3,4,xiaomi_redmi_note_11-5,2425,5108
Xiaomi Redmi Note 11,895,12900,23625,18370,3,4,xiaomi_redmi_note_11-6,2426,5255
Xiaomi Redmi Note 11,500,14400,25650,20532,3,3,xiaomi_redmi_note_11-7,2427,5118
Xiaomi Redmi Note 11,909,13800,23850,20584,4,3,xiaomi_redmi_note_11-8,2428,3266
Xiaomi Redmi Note 11,283,13800,23850,16614,1,2,xiaomi_redmi_note_11-9,2429,7236
Xiaomi Redmi Note 11,394,14400,22950,20172,4,3,xiaomi_redmi_note_11-10,2430,2778
Xiaomi Redmi Note 11,343,13950,25200,17607,2,5,xiaomi_redmi_note_11-11,2431,7593
Xiaomi Redmi Note 11,605,13800,25875,21951,4,3,xiaomi_redmi_note_11-12,2432,3924
Xiaomi Redmi Note 11,828,13050,25875,20938,3,1,xiaomi_redmi_note_11-13,2433,4937
Xiaomi Redmi Note 11,805,14850,24750,19553,3,5,xiaomi_redmi_note_11-14,2434,5197
Xiaomi Redmi Note 11,634,14850,23850,20475,4,5,xiaomi_redmi_note_11-15,2435,3375
Xiaomi Redmi Note 11,912,14850,25875,22844,5,1,xiaomi_redmi_note_11-16,2436,3031
Xiaomi Redmi Note 11,589,13350,22950,19830,5,3,xiaomi_redmi_note_11-17,2437,3120
Xiaomi Redmi Note 11,332,13050,24975,17105,1,1,xiaomi_redmi_note_11-18,2438,7870
Xiaomi Redmi Note 11,192,14550,25650,22043,4,3,xiaomi_redmi_note_11-19,2439,3607
Xiaomi Redmi Note 11,857,13950,25650,21263,5,5,xiaomi_redmi_note_11-20,2440,4387
Xiaomi Redmi Note 11,194,12900,24075,16532,2,5,xiaomi_redmi_note_11-21,2441,7543
Xiaomi Redmi Note 11,742,14850,23400,20408,4,4,xiaomi_redmi_note_11-22,2442,2992
Xiaomi Redmi Note 11,203,13800,25200,19557,2,1,xiaomi_redmi_note_11-23,2443,5643
Xiaomi Redmi Note 11,594,14250,25875,16110,1,4,xiaomi_redmi_note_11-24,2444,9765
Xiaomi Redmi Note 11,653,14850,23850,15750,1,5,xiaomi_redmi_note_11-25,2445,8100
Xiaomi Redmi Note 11,23,13950,23175,20177,5,3,xiaomi_redmi_note_11-26,2446,2998
Xiaomi Redmi Note 11,623,14100,25425,21179,5,5,xiaomi_redmi_note_11-27,2447,4246
Xiaomi Redmi Note 11,653,13800,22950,19519,5,5,xiaomi_redmi_note_11-28,2448,3431
Xiaomi Redmi Note 11,498,14250,23850,17802,2,4,xiaomi_redmi_note_11-29,2449,6048
